AssetAdapter=CHa
Avatar=CHb
AvatarPart=CHc
AvatarUrlManager=CHd
BaseInfoPlugin=CHe
AvatarBasePlugin=CHf
BaseModel=CHg
EuiComBase=CHh
ModuleBase=CHi
ViewBase=CHj
Dispatcher=CHk
EvtPattern=CHl
EvtListenPattern=CHm
GameEvent=CHn
ModuleEventType=CHo
ModuleBubbleVo=CHp
ModulePopVO=CHq
ModuleRedVo=CHr
MainLayer=CHs
LayerBase=CHt
MapCfg=CHu
MapLoader=CHv
TileLoaderProxy=CHw
MapLoadvo=CHx
TileMap=CHy
MapBgLayer=CHz
MapLayerBase=CHA
MapSceneAni=CHB
MapSceneAvt=CHC
MapSceneImg=CHD
MapSceneItem=CHE
YingziPlugin=CHF
MapNode=CHG
MapVO=CHH
MapContainer=CHI
MapItem=CHJ
MapItemVO=CHK
BytesSocket=CHL
NetEvent=CHM
NetDispatcher=CHN
NetVO=CHO
WebSocketEventType=CHP
SocketBase=CHQ
RoleBase=CHR
AvatarLoader=CHS
PlayerDataBaseVO=CHT
BitmapClipData=CHU
BitmapClipDataPool=CHV
BitmapFrame=CHW
BitmapFramePool=CHX
CMovieClip=CHY
CMovieClipData=CHZ
CMovieClipManager=CH1
OnlyIDCreater=CH2
SceneFrame=CH3
SceneSouce=CHba
SceneType=CHbb
SoundMgr=CHbc
SoundLoader=CHbd
SoundPlayer=CHbe
VivoSound=CHbf
VivoSoundItem=CHbg
SoundStatic=CHbh
Loop=CHbi
ArrayUtil=CHbj
CheckStringUtil=CHbk
ColorUtil=CHbl
DateUtil=CHbm
DisplayObjectPool=CHbn
FightUtil=CHbo
FilterUtil=CHbp
GameUtil=CHbq
GrayUtil=CHbr
HtmlUtil=CHbs
LocalCookieUtil=CHbt
MathConstant=CHbu
ModuleUtil=CHbv
NetRsp=CHbw
NetUtil=CHbx
NetWorkSystem=CHby
DataType=CHbz
PacketParm=CHbA
IObserver=CHbB
IPostData=CHbC
Observer=CHbD
PropUtil=CHbE
ShockCtrl=CHbF
StringUtil=CHbG
TypeUtil=CHbH
Vector2D=CHbI
FunctionVO=CHbJ
PropVo=CHbK
CQSceneAdapter=CHbL
ActiveMCPlayer=CHbM
EActiveType=CHbN
ActiveMCVO=CHbO
GameAlert=CHbP
App=CHbQ
AwardShow=CHbR
BigImgRes=CHbS
BoxVO=CHbT
BoxBase=CHbU
PureSkinBoxBar=CHbV
BuyTip=CHbW
FunctionVOExt=CHbX
CommonAlert=CHbY
PureSkinCheckBoxTwo=CHbZ
PureSkinCheckBox=CHb1
GridBookVo=CHb2
BoxGrid=CHb3
BoxGridVo=CHca
GridEquip=CHcb
GridEquipVo=CHcc
GridForge=CHcd
GridForgeVo=CHce
GridBase=CHcf
GridFactory=CHcg
GridStatic=CHch
GridVo=CHci
GridHero=CHcj
GridHeroVo=CHck
GridItem=CHcl
GridItemVo=CHcm
GridOrgEquip=CHcn
GridOrgEquipVo=CHco
GridSkill=CHcp
GridSkillVo=CHcq
SpecialIcon=CHcr
SpecialIconVo=CHcs
GridWearEquip=CHct
GridWearEquipVo=CHcu
ZhuzaiIcon=CHcv
HeroList=CHcw
HeroListVo=CHcx
NumChoose=CHcy
RewardFlyManger=CHcz
RewardFlyVo=CHcA
NewPureSkinTabBar=CHcB
PureSkinTabBar=CHcC
RedPoint=CHcD
TipBook=CHcE
TipDes=CHcF
TipDesManager=CHcG
TipEquip=CHcH
TipFightFigure=CHcI
TipHeroEquip=CHcJ
TipItem=CHcK
TipMagicProp=CHcL
TipOrangeEquip=CHcM
TipOrangeEquipManager=CHcN
TipComponent=CHcO
TipManger=CHcP
CdManager=CHcQ
Data_CountdownLabel=CHcR
DDisp=CHcS
BattleType=CHcT
BonusType=CHcU
CurrencyType=CHcV
EquipIndex=CHcW
EquipPos=CHcX
FamilyMemberState=CHcY
HurtType=CHcZ
Job=CHc1
LimitType=CHc2
Prop=CHc3
RoleType=CHda
GameCf=CHdb
GameLogSendUnit=CHdc
GameLogStep=CHdd
AddHpImageNum=CHde
DaoShiFightImageNum=CHdf
FaShiFightImageNum=CHdg
HurtTypeFont=CHdh
MyPlayerFightImageNum=CHdi
FightImageNum=CHdj
FightImages=CHdk
FightPowerImageNum=CHdl
FontImage=CHdm
ImageNum=CHdn
MainImages=CHdo
PowerUpImageNum=CHdp
LimitStatic=CHdq
LimitVO=CHdr
ResManager=CHds
UIManager=CHdt
MessageFBManager=CHdu
MessagLeftManager=CHdv
MessageManager=CHdw
MessageStatic=CHdx
SingleFBMessage=CHdy
SingleLeftMessage=CHdz
SingleMessage=CHdA
SinglePaoPaoMessage=CHdB
SingleRightMessage=CHdC
ModuleID=CHdD
ModuleManager=CHdE
ModuleSwitch=CHdF
Type_ModuleSwitch=CHdG
ParticleSys=CHdH
PowerUpEui=CHdI
PowerUpManger=CHdJ
PowerUpStatic=CHdK
CProgressBar=CHdL
HpBar=CHdM
MaskBar=CHdN
PureSkinHpBar=CHdO
PureSkinMaskBar=CHdP
PureSkinMultiHpBar=CHdQ
ResizeController=CHdR
DMNotice=CHdS
DMNoticeManger=CHdT
RunNotice=CHdU
RunNoticeManger=CHdV
RunNoticeVo=CHdW
Boom10Window=CHdX
Boom12Window=CHdY
Boom17Window=CHdZ
Boom1Window=CHd1
Boom2Window=CHd2
Boom3Window=CHd3
Boom4Window=CHea
Boom5Window=CHeb
Boom6Window=CHec
Boom7Window=CHed
Boom8Window=CHee
BoomWindow=CHef
GameWindow=CHeg
SmallGameWindow=CHeh
AchieveDS=CHei
AchieveDSEditor=CHej
AchieveJsonConfigData=CHek
ActiveTaskDS=CHel
ActiveTaskDSEditor=CHem
ActiveTaskJsonConfigData=CHen
ActDtS=CHeo
ActivityInfoEditor=CHep
ArtifactDS=CHeq
ArtifactDSEditor=CHer
BackActivityDS=CHes
BackActivityInfoEditor=CHet
DS=CHeu
EmDStor=CHev
EntertypeStatic=CHew
EnterTypeStoreDS=CHex
EquipDS=CHey
EquipDSEditor=CHez
EquipJsonConfigData=CHeA
ErrorcodeDS=CHeB
FamilyDS=CHeC
FamilyDSEditor=CHeD
FamilyJsonConfigData=CHeE
HefuActDS=CHeF
HeroCheckRedPointStatic=CHeG
HeroDataInfoStatic=CHeH
HeroDS=CHeI
HeroDSEditor=CHeJ
FulinVO=CHeK
MeridianVO=CHeL
WingVO=CHeM
ItemDS=CHeN
ItemDSEditor=CHeO
ItemJsonConfigData=CHeP
LotteryDS=CHeQ
LotteryDSEditor=CHeR
MineInfoDS=CHeS
MineInfoEditor=CHeT
PortInfoDS=CHeU
PortInfoDSEditor=CHeV
ServerTimeDS=CHeW
ServerTimeDSEditor=CHeX
ServerTimeEventType=CHeY
SignGet=CHeZ
LgM=CHe1
LanTxt=CHe2
AchMdu=CHe3
AchMed=CHfa
AchMod=CHfb
AchTaskMod=CHfc
ActTaskMod=CHfd
DrgBlCfg=CHfe
DrgBlMod=CHff
MedalCfg=CHfg
MedalMod=CHfh
AchTaskV=CHfi
AchV=CHfj
ActTaskV=CHfk
DrgBlV=CHfl
MedalV=CHfm
AchbtnRnd=CHfn
AchGroupVo=CHfo
AchTaskVo=CHfp
AchTLRnd=CHfq
AchTLVo=CHfr
ActTaskRnd=CHfs
ActTaskRndVo=CHft
MedalCfgVo=CHfu
AchPnl=CHfv
AchTaskPnl=CHfw
ActTaskPnl=CHfx
DrgBlPnl=CHfy
DrgLostPnl=CHfz
MedalPnl=CHfA
ActivityInitor=CHfB
CheckerInitor=CHfC
AliveInitor=CHfD
RedDotInitor=CHfE
PanelInitor=CHfF
ActivityViewFactory=CHfG
AliveCheckerFactory=CHfH
DefaultAliveChecker=CHfI
AliveChecker_ChrisRecharge=CHfJ
AliveChecker_Koireturn=CHfK
AliveChecker_CrossConsume=CHfL
AliveChecker_LimitShop=CHfM
AliveChecker_DailyPromotion=CHfN
AliveChecker_DailyPromotionStates=CHfO
AliveChecker_MisteryLimit=CHfP
AliveChecker_DirectBuy=CHfQ
AliveChecker_ContinueRecharge=CHfR
AliveChecker_CircleDaily=CHfS
AliveChecker_TimeGet=CHfT
LimitCheckerFactory=CHfU
NothingChecker=CHfV
LimitChecker1=CHfW
LimitChecker2=CHfX
LimitChecker3=CHfY
LimitChecker_Timeget=CHfZ
LimitChecker5=CHf1
LimitChecker6=CHf2
LimitChecker7=CHf3
LimitChecker8=CHga
LimitChecker10=CHgb
LimitChecker11=CHgc
LimitChecker12=CHgd
LimitChecker13=CHge
LimitChecker14=CHgf
LimitChecker15=CHgg
LimitChecker16=CHgh
LimitChecker17=CHgi
LimitBuyCheck=CHgj
LimitItemBuyCheck=CHgk
LimitOtherBuyCheck=CHgl
LimitMyValueChecker=CHgm
InvestLevelChecker=CHgn
ServerDrawsLimitChecker=CHgo
LimitChecker_ChargeAndBuy=CHgp
LimitChecker_ContinueRecharge=CHgq
LimitChecker_CircleRecharge=CHgr
LimitChecker_CircleConsume=CHgs
LimitChecker_CircleBoss=CHgt
RedCheckerFactory=CHgu
DefaultRedChecker=CHgv
RedChecker_Not=CHgw
RedChecker3=CHgx
RedChecker4=CHgy
RedChecker6=CHgz
RedChecker7=CHgA
RedChecker8=CHgB
RedChecker9=CHgC
RedChecker10=CHgD
RedChecker11=CHgE
RedChecker12=CHgF
RedChecker_LrDouble12=CHgG
RedChecker_LuckyRollerRebate=CHgH
RedChecker_LuckyRewardTurn=CHgI
RedChecker_BossPoint=CHgJ
CircleActivityVo=CHgK
CircleSubActivityVo=CHgL
CircleDailyCtrl=CHgM
CircleBossPanel=CHgN
CircleContinueRechargeRender=CHgO
ActivityBasePanel=CHgP
ActivityGetRewardBtn=CHgQ
GetRewardBtnVo=CHgR
CoverPanel=CHgS
ScrollerRewardPane=CHgT
SelectHorizontalListPane=CHgU
ContinueRechargeModule=CHgV
ContinueRechargeViewMediator=CHgW
ContinueRechargeCtrl=CHgX
ContinueRechargeVo=CHgY
ContinueRechargePanel=CHgZ
ContinueRechargeRender=CHg1
ActivityCrossConsumDes=CHg2
ActivityCrossXfPanel=CHg3
ActivityCrossXfRender=CHha
CrossConsumModel=CHhb
CrossXfVo=CHhc
DirectBuyModule=CHhd
DirectBuyViewMediator=CHhe
DirectBuyBoxRender=CHhf
DirectBuyPanel=CHhg
FPEvt=CHhh
FPMdu=CHhi
FPMed=CHhj
FPMod=CHhk
FPPnl=CHhl
FPType3=CHhm
IActivityChecker=CHhn
IAliveChecker=CHho
IRedChecker=CHhp
IInitor=CHhq
IActivityView=CHhr
ITuyouActivityView=CHhs
LREvt=CHht
LRMdu=CHhu
LRMed=CHhv
LRMod=CHhw
DBGrid=CHhx
DBGVo=CHhy
LRPnl=CHhz
ActivityModule=CHhA
ActivityViewMediator=CHhB
ActTaskPanel=CHhC
ALmtTitlePnl=CHhD
FestivalAnnualGoldenEggExtPnl=CHhE
FestivalLoginPanel=CHhF
FestivalLoginPart=CHhG
FestivalZhiShuCrazyPanel=CHhH
FestivalZhiShuResultPanel=CHhI
Fst11KoiPnl=CHhJ
FstGoldenEggDes=CHhK
FstMothersConstantRechargeExtPnl=CHhL
LrDouble12Des=CHhM
LrDouble12Pnl=CHhN
TotalRechargePanel=CHhO
TotalRechargeType1Panel=CHhP
WishBoxGetLogPanel=CHhQ
WishBoxRemainPanel=CHhR
WishingBoxPanel=CHhS
ProgressVo=CHhT
ActAnnualRender=CHhU
AnnualLoginRender=CHhV
CollectFontRender=CHhW
FestivalAnnualTaskBoxVo=CHhX
FestivalAnnualTaskBoxRender=CHhY
FestivalGoldenEggExtRender=CHhZ
FestivalLoginRender=CHh1
FestivalMotherLoginRender=CHh2
FestivalMotherRechargeRender=CHh3
Fst11KoiLogRender=CHia
LrDouble12Item=CHib
WishBoxLogRender=CHic
WishBoxPoolRender=CHid
WishBoxProcessRender=CHie
WishBoxRemainRender=CHif
WishBoxRender=CHig
WishBoxRewardRender=CHih
ActEvtType=CHii
ActivityConfig=CHij
ActivityID=CHik
ActivityClientKeyType=CHil
ActivityModel=CHim
AliveCheck=CHin
BtnRedCheck=CHio
ActivityBaseCtrl=CHip
ActivityLotteryCtrl=CHiq
AnnualTaskCtrl=CHir
ChargeAndBuyCtrl=CHis
ConstantRechargeLevelCtrl=CHit
ConsumeRechargeCtrl=CHiu
FestivalConstantRechargeCtrl=CHiv
LrDouble12Ctrl=CHiw
Lr12Info=CHix
Lr12ZoneVO=CHiy
LuckyRewardTurnCtrl=CHiz
RewardTurnShowVo=CHiA
LuckyRollerRebateCardCtrl=CHiB
LuckyRollerRebateCtrl=CHiC
Recharge3For4Ctrl=CHiD
ShaChengActivityCtrl=CHiE
WishboxCtrl=CHiF
DataTable=CHiG
IBridge=CHiH
ConfigManager=CHiI
LuckyRollerManager=CHiJ
LotteryManager=CHiK
GlobalEventManager=CHiL
CttList=CHiM
CttPicture=CHiN
DesBonus=CHiO
DesPart=CHiP
PartEffMgr=CHiQ
PartBase=CHiR
PartText=CHiS
PtTagCorrespond=CHiT
CttRender1=CHiU
CttRender10=CHiV
CttRender11=CHiW
CttRender12=CHiX
CttRender13=CHiY
CttRender14=CHiZ
CttRender2=CHi1
CttRender3=CHi2
CttRender4=CHi3
CttRender5=CHja
CttRender6=CHjb
CttRender7=CHjc
CttRender8=CHjd
CttRender9=CHje
DailyBuyPromptPanel=CHjf
ActBtn=CHjg
ActivityBtn=CHjh
BaseListItemRender=CHji
RewardRender=CHjj
RwdR=CHjk
SpecialItemGridRender=CHjl
ActivityMainPanel=CHjm
ActivityRankListPanel=CHjn
ActivityDesType1Panel=CHjo
CircleRechargeDes=CHjp
CircleConsumeDes=CHjq
ActivityInvestLevelDesPanel=CHjr
ActivityPay2Des=CHjs
ActivityShachengDes=CHjt
ActivityShop=CHju
ActivityShopConsumeDes=CHjv
SimpleDesPanel=CHjw
ChargeBuyDesPanel=CHjx
BossPointDesPanel=CHjy
AcivityConstantRechargeLevelPanel=CHjz
ActivityChargeBuyPanel=CHjA
ContentListPanel=CHjB
InvestLevelPanel=CHjC
OpenServerPlayerLevelPanel=CHjD
CircleContinueChargePanel=CHjE
CircleConsumePanel=CHjF
ActivityCrazyLotteryPanel=CHjG
ActivityShachengPanel=CHjH
ActivityType11Panel=CHjI
ActivityType12Panel=CHjJ
ActivityType13Panel=CHjK
ActivityType14Panel=CHjL
ActivityType41Panel=CHjM
ActivityType5ExtPnl=CHjN
LimitFashionVo=CHjO
ActivityType6Panel=CHjP
ActivityTypeBossKillPanel=CHjQ
DataBossPoint=CHjR
ActKaifuLuckyShop=CHjS
ActPubBossPnl=CHjT
ActRecharge3For4Pnl=CHjU
ActSalePromotionPnl=CHjV
FashionShowPanel=CHjW
FashionShowRender=CHjX
LotteryResultPanel=CHjY
LuckyRewardTurnDesPanel=CHjZ
LuckyRewardTurnPanel=CHj1
RewardTurnShowItem=CHj2
LuckyRewardTurnResultPanel=CHj3
RewardTurnResultRender=CHka
LuckyRollerRebatePnl=CHkb
ActivityBossKillRender=CHkc
ActivityConstantRechargeLevelRender=CHkd
CrazyBoxRenderVO=CHke
ActivityCrazyBoxRender=CHkf
ActivityListRender1=CHkg
CircleConsumeRender=CHkh
ActivityRankInfoRender=CHki
ActivityRankRender=CHkj
ActivityRender41=CHkk
ActivityRender6=CHkl
ActivityRender7=CHkm
ActivityShachengRender=CHkn
ActivityShopRender=CHko
ActivityTimeGetRender=CHkp
ActKaifuLuckyShopRender=CHkq
ActRecharge3For4Render=CHkr
ActSalePromotionPnlRender=CHks
ActSalePromotionPnlRender1=CHkt
APubBossRender=CHku
AShpR=CHkv
ChargeAndBuyRender=CHkw
DoubleRechargeRender=CHkx
InvestLevelRender=CHky
LimitFashionFinalRender=CHkz
LotteryDesRender=CHkA
LuckyRewardTurnLogRender=CHkB
PlayerLevelRender=CHkC
MisteryLimitModule=CHkD
MisteryLimitViewMediator=CHkE
MisteryLimitPanel=CHkF
MoNMod=CHkG
MonsterNianBox=CHkH
MonsterNianController=CHkI
MonsterNianRewardPanel=CHkJ
MonsterNianRewardRender=CHkK
MoNRwdV=CHkL
NianViewBase=CHkM
OnlineItemVO=CHkN
OnlineModel=CHkO
OnlineModule=CHkP
OnlineViewMediator=CHkQ
BoxGridItem=CHkR
OnlinePanel=CHkS
UpdActModel=CHkT
UpdActModule=CHkU
UpdActViewMediator=CHkV
UpdEvt=CHkW
UpdDesType1=CHkX
UpdBossNumRender=CHkY
UpdBtn=CHkZ
UpdRender1=CHk1
UpdTsRender=CHk2
UpdActBossNumPnl=CHk3
UpdActPnl1=CHla
UpdActThemeShopPnl=CHlb
UpdBtnVo=CHlc
UpdSubVo=CHld
UpdVo=CHle
ActivityUtil=CHlf
JsonUtil=CHlg
ABVo=CHlh
ActCardCfgVo=CHli
ActivityBtnVo=CHlj
ActivityNewInfo=CHlk
ActivityRankVo=CHll
ActivityRewardVo=CHlm
ActivitySubVo=CHln
ActivityVo=CHlo
ActRebateConfigVo=CHlp
ActRebateVo=CHlq
ARkVo=CHlr
DataPropertyChange=CHls
FestivalAnnualTaskSubVo=CHlt
FestivalAnnualTaskVo=CHlu
FestivalDouble11Vo1=CHlv
FestivalGoldenEggVo=CHlw
FestivalMotherRcgVo=CHlx
FestivalMotherRcgSubVo=CHly
RegisterRedVo=CHlz
WishBoxRewardPoolVo=CHlA
RewardPoolLevel=CHlB
WishBoxRewardVo=CHlC
ArtifactMdu=CHlD
ArtifactMed=CHlE
ArtCfg=CHlF
ArtifactMod=CHlG
ArtStatic=CHlH
ZhanWenHcVo=CHlI
ZwFtVo=CHlJ
ZwInfoVo=CHlK
ZwMulVo=CHlL
AfTipEui=CHlM
ArtMainV=CHlN
ArtfGridVo=CHlO
ArtifactGrid=CHlP
KfRdVo=CHlQ
ArfEui=CHlR
ZhanWenChargePanel=CHlS
ZhanWenComPanel=CHlT
ZhanWenTipPanel=CHlU
ZwAlertEui=CHlV
ZwEui=CHlW
ZwFetEui=CHlX
ZwRepEui=CHlY
ZwResvEui=CHlZ
ZwTipEui=CHl1
ZhanWenChargeRender=CHl2
ZhanWenComRender=CHl3
ZwRd=CHma
ZwRepRd=CHmb
ZwResRd=CHmc
ZwMainV=CHmd
ZhanWenMed=CHme
BabelBoxController=CHmf
BabelMainViewMediator=CHmg
BabelModule=CHmh
BabelViewMediator=CHmi
BabelStatic=CHmj
BabelBoxModel=CHmk
BabelBoxInfo=CHml
BabelConfigModel=CHmm
BabelModel=CHmn
BabelPlayerModel=CHmo
BabelJiFenRen=CHmp
BabelRankRen=CHmq
BabelResultRen=CHmr
BabelRoleRen=CHms
BabelRwdRen=CHmt
BabelScoreRen=CHmu
BabelAchieveView=CHmv
BabelAttackersView=CHmw
BabelAttView=CHmx
BabelBox=CHmy
BabelBuffView=CHmz
BabelEndView=CHmA
BabelFlag=CHmB
BabelItemDesView=CHmC
BabelJiFenView=CHmD
BabelMainRankView=CHmE
BabelNextFloor=CHmF
BabelPrepareView=CHmG
BabelRadPanel=CHmH
BabelRankView=CHmI
BabelRebornView=CHmJ
BabelRwdView=CHmK
BabelView=CHmL
BabelScenePlayerVo=CHmM
BjiFenVo=CHmN
ItemVo=CHmO
BagMdu=CHmP
BagMed=CHmQ
BagMgr=CHmR
Bagjsn=CHmS
BagMod=CHmT
BagV=CHmU
BagEui=CHmV
BagGrdR=CHmW
BagSEui=CHmX
BagspdEui=CHmY
BagSR=CHmZ
ChNaEui=CHm1
ItuEui=CHm2
BossMdu=CHm3
BossMed=CHna
BossOtherMgr=CHnb
MapBossHpMed=CHnc
ZSBossLuckyMed=CHnd
BossEvt=CHne
BossCfgMod=CHnf
BossMod=CHng
PublicBossMod=CHnh
QMBossCfgMod=CHni
QMBSPvpMsg=CHnj
QMBSPvpItem=CHnk
SMBossMed=CHnl
BossTXV=CHnm
BossV=CHnn
BossZSRwdV=CHno
HowToPlayV=CHnp
HowToPlayMed=CHnq
MapBossHpPnl=CHnr
MapBossHpV=CHns
MapBossHurtRnd=CHnt
QmPvpItemRnd=CHnu
QMBossRwdV=CHnv
BossAllRnd=CHnw
BossAutoRnd=CHnx
BossOneRnd=CHny
BossQdInfoRender=CHnz
BossRankRnd=CHnA
BossTXRnd=CHnB
BossZHRnd=CHnC
BossZSRnd=CHnD
BossZSRwdRnd=CHnE
SMBossV=CHnF
BossAlertRveg=CHnG
BossAllPnl=CHnH
BossFuChouAlert=CHnI
BossOnePnl=CHnJ
BossPnl=CHnK
BossQdInfoPanel=CHnL
BossRankPnl=CHnM
BossTXPnl=CHnN
BossZHPnl=CHnO
BossZSPnl=CHnP
BossZSRwdPnl=CHnQ
HowToPlayPnl=CHnR
SMBossPnl=CHnS
ZSBossLuckyPnl=CHnT
ZSBossLuckyV=CHnU
BossAllVO=CHnV
BossAutoCfgVo=CHnW
BossAutoVo=CHnX
BossLogVo=CHnY
BossOneVO=CHnZ
BossZHVO=CHn1
BossZSRewardVO=CHn2
BossZSVO=CHn3
OtherPlyActVo=CHoa
SMBossVO=CHob
ChatMdu=CHoc
ChatMed=CHod
ChatET=CHoe
ChatCMod=CHof
ChatMod=CHog
ChatStatic=CHoh
ChatV=CHoi
SChlRed=CHoj
SChlRVo=CHok
WChlRed=CHol
WChlRVo=CHom
ChatBtn=CHon
ChatEui=CHoo
ChatSettingView=CHop
EmojiPan=CHoq
EmojiText=CHor
SchlEui=CHos
WchlEui=CHot
CHaoCfgMod=CHou
CHaoItemRnd=CHov
ChengHaoMdu=CHow
ChengHaoMod=CHox
ChengHaoPnl=CHoy
ChengHaoV=CHoz
ChengHaoVMed=CHoA
CityPlayer=CHoB
Statue=CHoC
BnAlertEui=CHoD
bigGnifeAlert=CHoE
gnifeAlert=CHoF
MCityType=CHoG
MainCityBossMgr=CHoH
MainCityMdu=CHoI
MainCityMed=CHoJ
MainCityMgr=CHoK
MainCitySMgr=CHoL
MaincityMod=CHoM
MainSBoxMod=CHoN
FesBoxInfo=CHoO
TreAlertEui=CHoP
BoxCDSEui=CHoQ
SprFBoxEui=CHoR
SprFProgEui=CHoS
MainCityVo=CHoT
CrBossFightViewMediator=CHoU
CrBossModule=CHoV
CrBossViewMediator=CHoW
CrBossEventType=CHoX
CrBossModel=CHoY
ICrBossAchieveTaskVo=CHoZ
CrBossPlayerModel=CHo1
PvpsInsModel=CHo2
IEnterInsData=CHo3
InsSencePlayer=CHpa
InsActionData=CHpb
ICrBossMonStateInfo=CHpc
PvpsInsRoleVo=CHpd
PvpsInsHeroInfo=CHpe
PvpsInsMonInfo=CHpf
CrBossUtil=CHpg
AlertConfirm=CHph
CrBossAchieveEui=CHpi
CrBossAlertView=CHpj
CrBossBar=CHpk
CrBossBuyPanelEui=CHpl
CrBossChatChannelEui=CHpm
CrBossDieImg=CHpn
CrBossFightView=CHpo
CrBossHead=CHpp
CrBossLTView=CHpq
CrBossReborn=CHpr
CrBossRecordView=CHps
CrBossResultView=CHpt
CrBossRoleRen=CHpu
CrBossRoleRightRen=CHpv
CrBossSettingView=CHpw
CrBossView=CHpx
CrBossAchieveRender=CHpy
CrBossChatRnd=CHpz
CrBossRecordRender=CHpA
CrossHSModel=CHpB
CrsHSMdu=CHpC
CrsHSVMed=CHpD
crossHSViewReqType=CHpE
ICrossHSView=CHpF
CrossHSEventType=CHpG
CrossFamilyLogRender=CHpH
CrossHSAwardBox=CHpI
CrossHSCarEndRander=CHpJ
CrossHSCarPlayerRender=CHpK
CrossHSCarRender=CHpL
CrossHSFamilyItemRender=CHpM
CrossHSFamilyItemVo=CHpN
CrossHSFPRender=CHpO
CrossHSPlayerItemRender=CHpP
CrossPlayerLogRender=CHpQ
CrossQiangduoRender=CHpR
CrossHSBuyTokenTip=CHpS
CrossHSCarEndTip=CHpT
CrossHSCarInfoView=CHpU
CrossHSDieShowView=CHpV
CrossHSFamilyCar=CHpW
CrossHSFamilyRankView=CHpX
CrossHSFPRankView=CHpY
CrossHSMoveView=CHpZ
CrossHSPlayerRankView=CHp1
CrossHSQJTip=CHp2
CrossHSRadio=CHp3
CrossHSRecordView=CHqa
CrossHSResultView=CHqb
CrossHSSHView=CHqc
CrossHSView=CHqd
CrossHSVsView=CHqe
CrossQiangDuoPanel=CHqf
CrossRankModel=CHqg
CrossRankModule=CHqh
CrossRankViewMediator=CHqi
CrossDonateView=CHqj
CrossHonourView=CHqk
CrossRankView=CHql
CrossDonRen=CHqm
CrossHonRen=CHqn
CrossRankRen=CHqo
CrossDonVo=CHqp
CrossHonVo=CHqq
CrossRankVo=CHqr
CrossStatus=CHqs
CrsSpMdu=CHqt
CrsSpMed=CHqu
CrsSvrMdu=CHqv
ICrossModel=CHqw
CrsSvrVMed=CHqx
CrsSvrMod=CHqy
CrsSpPnl=CHqz
CrsSpRnd=CHqA
CrsSvrV=CHqB
CSPlaysetRender=CHqC
CrsSpVo=CHqD
KFTTEvt=CHqE
KFTTMdu=CHqF
KFTTMed=CHqG
KFTTMod=CHqH
KFTTDWAwardV=CHqI
KFTTAwardRnd=CHqJ
KFTTInfoV=CHqK
KFTTKingAwardVo=CHqL
KFTTKingListCV=CHqM
KFTTKingListLV=CHqN
KFTTKingRnd=CHqO
KFTTKingVo=CHqP
KFTTRadio=CHqQ
KFTTStageV=CHqR
KFTTV=CHqS
KFTTVsV=CHqT
KFTTWinV=CHqU
CrSandyInViewMediator=CHqV
CrSandyModule=CHqW
CrSandyViewMediator=CHqX
CrSandyEventType=CHqY
TimeOutSet=CHqZ
CrBetStatus=CHq1
CrSandyModel=CHq2
CrSandyPlayerModel=CHq3
CrSandyFieldType=CHra
CsCfg=CHrb
CsTeamStatusType=CHrc
PvpsBaseModel=CHrd
IPos=CHre
IEnterSceneData=CHrf
IKillData=CHrg
IOtherPosInfo=CHrh
IOtherEnterInfo=CHri
ScenePlayer=CHrj
CrSandyUtil=CHrk
CrSandyAttackersView=CHrl
ScenePlayerId=CHrm
CrSandyAwardPnl=CHrn
CrSandyBetConfirmPnl=CHro
CrSandyBetPnl=CHrp
CrSandyBuyBuffPnl=CHrq
CrSandyBuyTip=CHrr
CrSandyChearupPnl=CHrs
CrSandyClearCdPnl=CHrt
CrSandyEnemyView=CHru
CrSandyFamilyRankPnl=CHrv
CrSandyFamilyStatPnl=CHrw
CrSandyFinalPnl=CHrx
CrSandyInnerPnl=CHry
EffectDicInfo=CHrz
CrSandyMyFamilyPnl=CHrA
CrSandyPrePnl=CHrB
CrSandyResultPnl=CHrC
CrSandyView=CHrD
CrSandyBetLogRender=CHrE
CrSandyBetRender=CHrF
CrSandyFamilyRankRender=CHrG
CrSandyPopRender=CHrH
CrSandyPreRender=CHrI
CrSandyRwdRender=CHrJ
CrSandyStatRender=CHrK
CsBetLimitVo=CHrL
CsFamilyInfoVo=CHrM
CsFamilyStatVo=CHrN
CsMyBetSingleVo=CHrO
CsMyBetVo=CHrP
CsWarInfoVo=CHrQ
PvpsScenePlayerVo=CHrR
EmMdu=CHrS
EmMed=CHrT
EmMod=CHrU
EmV=CHrV
EmRed=CHrW
EmRVo=CHrX
EmCPan=CHrY
EmPan=CHrZ
ZYZEvt=CHr1
MeetCfgMod=CHr2
ZYZMod=CHr3
EncounterAdd=CHsa
ZYZBossP=CHsb
ZYZFgtDataP=CHsc
ZYZFgtDataRnd=CHsd
ZYZFightRnd=CHse
ZYZMainP=CHsf
ZYZRank=CHsg
ZYZRankRnd=CHsh
ZYZAlert=CHsi
ZYZBossV=CHsj
ZYZMainV=CHsk
MeetBossVO=CHsl
MeetRptVO=CHsm
RuleDescVO=CHsn
ZYZFgtVO=CHso
ZYZRankVO=CHsp
ZYZBossMed=CHsq
ZYZMdu=CHsr
ZYZMed=CHss
EnemyET=CHst
EnemyCfgMod=CHsu
EnemyModel=CHsv
EnemyPanel=CHsw
EnemyRender=CHsx
EnemyVO=CHsy
FbMdu=CHsz
FbViewMed=CHsA
FabaoCfg=CHsB
FabaoShopOnlyVo=CHsC
fabaoPartVo=CHsD
FbActVo=CHsE
FbEvtType=CHsF
FbMod=CHsG
FbPartMod=CHsH
FbSkillvo=CHsI
FabaoDesc=CHsJ
FabaoPartEui=CHsK
FabaoParticon=CHsL
FabaoPartLvupEui=CHsM
fabaoProDes=CHsN
FabaoRadio=CHsO
FabaoShop=CHsP
FabaoShopBtn=CHsQ
FaobaoArticactEui=CHsR
FaobaoCuilianEui=CHsS
FbCqBagGridRnd=CHsT
FbJihuoRndr=CHsU
FbShopListRndr=CHsV
FamilyLstMed=CHsW
FamilyModu=CHsX
FamScreenMed=CHsY
FamCpVo=CHsZ
FamilyTrialEff=CHs1
VO_TrialLimitVO=CHs2
VO_TrialBuffVO=CHs3
VO_TrialScoreVO=CHta
VO_TrialPortVO=CHtb
TrialBuffVO=CHtc
TrialPortVO=CHtd
FamilyEvt=CHte
FamilyMod=CHtf
FamilyTrialAuto=CHtg
FamilyTrialModel=CHth
FMPOS=CHti
FamilyBagV=CHtj
FamilyListV=CHtk
FamilyMainV=CHtl
FamilyScrnV=CHtm
FamilyShopV=CHtn
FamilySkV=CHto
FamilyTaskV=CHtp
FamilyTrialResult=CHtq
FamilyTrialScene=CHtr
FamilyTrialView=CHts
RedPacketEui=CHtt
FamBagBoxRd=CHtu
FamBulRd=CHtv
FamHLRd=CHtw
FamIfLiRd=CHtx
FamilyHDVo=CHty
FamilyShopVo=CHtz
FamilySkillVo=CHtA
FamilyTaskVo=CHtB
FamilyTrialBox=CHtC
FamRLRd1=CHtD
FamShopLRd=CHtE
FamTLRd=CHtF
FamTrialBuffBtn=CHtG
FamTrlBuffRankRndr=CHtH
FamTrlBuffRndr=CHtI
FamTrlBuffRndr2=CHtJ
FamTrlBuffShow=CHtK
FamTrlRankRndr=CHtL
GrFaSkRd=CHtM
MemGxLiRd=CHtN
MemIfBLRd=CHtO
MemILRd=CHtP
MemInLRd1=CHtQ
OtFaIfVo=CHtR
ReqMLRd=CHtS
SetOfferRd=CHtT
SetofferVo=CHtU
EdFaNotEui=CHtV
FaBoxEui=CHtW
FaBpEui=CHtX
FaBREui=CHtY
FaBRPEui=CHtZ
FaCpEui=CHt1
FaCrtPalEui=CHt2
FaHdLstEui=CHt3
FalDtPalEui=CHua
FalLstEui=CHub
FalLstEui2=CHuc
FalMLstEui=CHud
FamGhSklPnl=CHue
FamSkillId=CHuf
FamilyEui=CHug
FamilyHorDonPanel=CHuh
FamilyHorDonRender=CHui
FamilyTrialBuffBuyAlert=CHuj
FamilyTrialBuffPanel=CHuk
TrialPlayerBuffRankVO=CHul
TrialBuffRankVO=CHum
FamilyTrialBuffs=CHun
FamilyTrialMsg=CHuo
FamilyTrialSingleMsg=CHup
FamilyTrialPanel=CHuq
FamilyTrialRankPanel=CHur
FamilyTrialRwdSelect=CHus
FamyGhSklTabPnl=CHut
FaScreenEui=CHuu
FaSkEui=CHuv
FaSpEui=CHuw
FaSpLstEui=CHux
FaSpLstEui1=CHuy
FaTaskEui=CHuz
FaTkLstEui=CHuA
ReqLstEui=CHuB
SetLeadEui=CHuC
SetOfferEui=CHuD
FamDonateVo=CHuE
FzEventType=CHuF
FzModule=CHuG
FzSubViewMed=CHuH
FzViewMed=CHuI
FAZHENTAB=CHuJ
FAZHEN=CHuK
FzModel=CHuL
FzComRder=CHuM
FzItem=CHuN
FzAwakeView=CHuO
FzBarView=CHuP
FzCompView=CHuQ
FzTabView=CHuR
FzTip=CHuS
FzUpView=CHuT
FaZhenAwkVo=CHuU
FaZhenComVo=CHuV
FaZhenUpVo=CHuW
FaZhenVo=CHuX
FightRMdu=CHuY
FightRMed=CHuZ
FightRV=CHu1
FightLoseP=CHu2
ModLvlInfo=CHu3
FightWinP=CHva
FPveLoseRender=CHvb
FPvpLoseRender=CHvc
ZSWinP=CHvd
ForgeMdu=CHve
ForgeMed=CHvf
ForgeCFGMod=CHvg
ForgeMod=CHvh
ForgeStatic=CHvi
ForgeV=CHvj
ForgeStoneRnd=CHvk
ForgeStoneRndVo=CHvl
ForgeAlert=CHvm
ForgeEnhance=CHvn
ForgeFulin=CHvo
ForgePnl=CHvp
ForgeSoul=CHvq
ForgeStone=CHvr
UpBtn=CHvs
ForgeFulinSglLvVo=CHvt
CTGMed=CHvu
FubenEvt=CHvv
FBCLMed=CHvw
FubenMdu=CHvx
FubenCfgMod=CHvy
FubenMod=CHvz
BossDlgBle=CHvA
CTGV=CHvB
FBCLV=CHvC
FBSDTipV=CHvD
FBSDTipMed=CHvE
FBTZV=CHvF
FBCLRnd=CHvG
CTGPnl=CHvH
FBCLPnl=CHvI
FBPnl=CHvJ
FBSDTip=CHvK
FBTZPnl=CHvL
FBCLVO=CHvM
FBPortVO=CHvN
FBTZVO=CHvO
FunNoticeMdu=CHvP
FunNoticeMed=CHvQ
FuninfoVo=CHvR
FunNEvent=CHvS
FunNoticeCfg=CHvT
FunNoticeMod=CHvU
NoticeRender=CHvV
FunGridEui=CHvW
FunNoticePnl=CHvX
GWMdu=CHvY
GWMed=CHvZ
GWMod=CHv1
GWV=CHv2
GWRed=CHv3
GWRVo=CHwa
GWPan=CHwb
GWTPan=CHwc
Guide=CHwd
GuideMod=CHwe
GuideRegist=CHwf
GuideTool=CHwg
GuideEui=CHwh
GuideMask=CHwi
GuideView=CHwj
BeginVo=CHwk
GuideNodeVO=CHwl
GuideVO=CHwm
HfMdu=CHwn
HfMed=CHwo
HFActEVT=CHwp
HfCk=CHwq
HfMod=CHwr
HefuClientkey=CHws
HefuActivityBossDes=CHwt
HefuActivityDes=CHwu
HefuActivityLoginDes=CHwv
HefuActivityPay3Des=CHww
HefuActivityPay4Des=CHwx
HefuActivityShachengDes=CHwy
HefuActivityXunbaoDes=CHwz
HefuDiscountDesPanel=CHwA
HfMPnl=CHwB
HefuActivityBossPanel=CHwC
HefuDataBossPoint=CHwD
HefuActivityConstantRechargePanel=CHwE
HefuActivityConsumeRankPanel=CHwF
HefuActivityDailyRechargePanel=CHwG
HefuActivityDiscountBagPanel=CHwH
HefuActivityDoubleRechargePanel=CHwI
HefuActivityLoginRwdPanel=CHwJ
HefuActivityRankListPanel=CHwK
HefuActivityShachengPanel=CHwL
HefuActivityShopPanel=CHwM
HefuActivityVIPPanel=CHwN
HefuActivityXunbaoPanel=CHwO
HefuActXunbaoBagPanel=CHwP
ABossKR=CHwQ
HefuActivityVipBtnRender=CHwR
HfCrkR=CHwS
HfR1=CHwT
HfR2=CHwU
HfR3=CHwV
HfRkR=CHwW
HfRwdR=CHwX
HfRwdR2=CHwY
HfActVo=CHwZ
HfBtnVo=CHw1
HfRkVo=CHw2
HfRvo=CHw3
HfSvo=CHxa
HBEventType=CHxb
HBVo=CHxc
HBModule=CHxd
HBViewMediator=CHxe
HBModel=CHxf
RedPacketVo=CHxg
FstHbPanel=CHxh
HbBonusShowPanel=CHxi
HBBtn=CHxj
HbChoose=CHxk
HbGetShow=CHxl
HbLog=CHxm
HbLogRender=CHxn
HBRain=CHxo
HBImg=CHxp
HbSendPanel=CHxq
HBSingleRwdPanel=CHxr
HBSysGetRder=CHxs
HBSysPanel=CHxt
IosPayMdu=CHxu
IosPayMed=CHxv
IosPayMed1=CHxw
NewIosPayMed=CHxx
IosPayV=CHxy
IosPayVo=CHxz
NewIosPayV=CHxA
IosPay1Eui=CHxB
IosPayEui=CHxC
IosPayRed=CHxD
NewIosPayEui=CHxE
KEType=CHxF
KFRVMed=CHxG
KingMdu=CHxH
KingMed=CHxI
KCMod=CHxJ
KingMod=CHxK
KFRV=CHxL
KingV=CHxM
KLWRed=CHxN
KLWTRed=CHxO
KRRed=CHxP
KFPan=CHxQ
KFWPan=CHxR
KLWPan=CHxS
KPan=CHxT
KRPan=CHxU
KRaVo=CHxV
KRVo=CHxW
LTSuitMdu=CHxX
LTSuitVMed=CHxY
LsuitVo=CHxZ
LtBagVo=CHx1
LTEventType=CHx2
LT=CHx3
THUNDERICON=CHya
LTMod=CHyb
LtPlayer=CHyc
LTStatic=CHyd
LTCuiLianTip=CHye
LTCuiLianView=CHyf
LTExchangeView=CHyg
LTLeiDesTipView=CHyh
LTLeiSuitView=CHyi
LTResolveListView=CHyj
LTResolveView=CHyk
LTSuitTipView=CHyl
LTSuitView=CHym
LTTabView=CHyn
cuiLianVo=CHyo
LTCuiLianRder=CHyp
LTExItemRder=CHyq
LTLeiSelectVo=CHyr
LTLeiRder=CHys
LTLeiReplaceRder=CHyt
LTRoveRder=CHyu
LTSuitVo=CHyv
LTSuitRder=CHyw
LkItem=CHyx
LkItemVo=CHyy
LkShineVo=CHyz
LkRollerModule=CHyA
LkRollerViewMediator=CHyB
LkRollerEvt=CHyC
LkRollerModel=CHyD
LkRollerPanel=CHyE
LockMonMdu=CHyF
LockMonMed=CHyG
LockMMod=CHyH
LockMonEvtT=CHyI
LockMVo=CHyJ
LockMonV=CHyK
LMItem=CHyL
LMPan=CHyM
LMSce=CHyN
LMSPan=CHyO
LMWPan=CHyP
LockAlertPanel=CHyQ
LockGiftAlertPanel=CHyR
CreateNewViewMed=CHyS
CreatNewView=CHyT
CrtMed=CHyU
LoginEvt=CHyV
LoginMdu=CHyW
LoginMed=CHyX
ReloginMed=CHyY
CreateEui=CHyZ
CreateNewEui=CHy1
CreateView=CHy2
LoginEui=CHy3
LoginView=CHza
RecEui=CHzb
RecView=CHzc
LotteryMdu=CHzd
LotteryMed=CHze
LotteryCfg=CHzf
LotteryMod=CHzg
LottDepotV=CHzh
LotteryDes=CHzi
LotteryV=CHzj
LottGetV=CHzk
DepotRed=CHzl
DepotVo=CHzm
LotteryRed=CHzn
LottDPan=CHzo
LottGPan=CHzp
LottPan=CHzq
LottRPan=CHzr
LRlMod=CHzs
LuckyRollerViewMediator=CHzt
LuckyRoller10Panel=CHzu
LuckyRollerItem=CHzv
LuckyRollerPanel=CHzw
MPropET=CHzx
MPropMod=CHzy
MagicConf=CHzz
MPropMdu=CHzA
MPropMed=CHzB
MagicExItm=CHzC
MagicExItmVo=CHzD
GridMagicItm=CHzE
GridMagicItmVo=CHzF
SXMagicItm=CHzG
SXMagicItmVo=CHzH
MagicJiban=CHzI
MPropExEui=CHzJ
MPropFEui=CHzK
MPropREui=CHzL
MPropV=CHzM
MainEvt=CHzN
MainMdu=CHzO
MainMed=CHzP
MainMgr=CHzQ
MainCf=CHzR
MainMod=CHzS
clcV=CHzT
CustomerEui=CHzU
MainBtnV=CHzV
MainEui=CHzW
MainLeftEui=CHzX
MainSettingView=CHzY
MainTopEui=CHzZ
SuprMainRender=CHz1
MainView=CHz2
MduGEui=CHz3
MduGpV=CHAa
MnBEui=CHAb
MnBpEui=CHAc
MnBpV=CHAd
MnEft=CHAe
MnLeftV=CHAf
MnPtV=CHAg
BubbleEui=CHAh
MainEnemyView=CHAi
ManHyEui=CHAj
MnPtEui=CHAk
MnRbEui=CHAl
MuGRender=CHAm
MainButtonVO=CHAn
ModuleGiftVo=CHAo
MainCityBossMediator=CHAp
MainCityBossModule=CHAq
MainCityBossModel=CHAr
MainCityMonster=CHAs
MainBossHp=CHAt
MainCityBossCheckPnl=CHAu
MainCityBossHurtRank=CHAv
MainCityBossHurtRender=CHAw
MainCityBossHurtRender2=CHAx
MainCityBossResultPnl=CHAy
MainCityBossRwdRender=CHAz
MCBEvtBuffPnl=CHAA
MCBEvtPnl=CHAB
MCBEvtRstPnl=CHAC
MainCityBossVo=CHAD
AStar=CHAE
MathUtil=CHAF
BatRpPlayer=CHAG
BattlePlayer=CHAH
ActionType=CHAI
Action=CHAJ
BattlePosMod=CHAK
BattleRepMod=CHAL
RoleTlMdf=CHAM
TimeSlice=CHAN
Bullet=CHAO
Bullet100=CHAP
Bullet11=CHAQ
Bullet12=CHAR
Bullet13=CHAS
Bullet14=CHAT
Bullet15=CHAU
Bullet16=CHAV
Bullet17=CHAW
Bullet18=CHAX
Bullet19=CHAY
Bullet2=CHAZ
Bullet20=CHA1
Bullet21=CHA2
Bullet22=CHA3
Bullet23=CHBa
Bullet24=CHBb
Bullet25=CHBc
Bullet26=CHBd
Bullet27=CHBe
Bullet28=CHBf
Bullet29=CHBg
Bullet3=CHBh
Bullet30=CHBi
Bullet31=CHBj
Bullet32=CHBk
Bullet33=CHBl
Bullet34=CHBm
Bullet35=CHBn
Bullet36=CHBo
Bullet37=CHBp
Bullet38=CHBq
Bullet39=CHBr
Bullet4=CHBs
Bullet5=CHBt
Bullet6=CHBu
Bullet7=CHBv
Bullet8=CHBw
Bullet9=CHBx
BulletAttack=CHBy
BulletReLive=CHBz
BatStaMgr=CHBA
BattLeMgr=CHBB
MapPlayerMgr=CHBC
MapEventType=CHBD
FindPathV=CHBE
AtkSkPlayer=CHBF
DiaBubble=CHBG
FaBao=CHBH
Monster=CHBI
MyPlayer=CHBJ
Npc=CHBK
OtherPet=CHBL
OtherPlayer=CHBM
Pet=CHBN
Player=CHBO
Role=CHBP
RoleUnit=CHBQ
SmartRole=CHBR
UIMonsterr=CHBS
MapMdu=CHBT
MapMed=CHBU
BattleCfgMod=CHBV
BattleMod=CHBW
MapMod=CHBX
MonsterHpBar=CHBY
SelfHpBar=CHBZ
MapConfigVO=CHB1
MapPlaData=CHB2
QuanMrankVO=CHB3
Fire=CHCa
MasterMdu=CHCb
MasterMed=CHCc
MasterScenceMed=CHCd
CrMasterPlayerModel=CHCe
MasterCfg=CHCf
MasterEvt=CHCg
MasterMod=CHCh
Mtaskvo=CHCi
MterCtvo=CHCj
PvpsMasterbaseModel=CHCk
IEnterCrMasterInsData=CHCl
PvpsMasterPlayerVo=CHCm
ApprenRnd=CHCn
ApprenticeEui=CHCo
CrMasterChatChannelEui=CHCp
ExplainEui=CHCq
MasterAlertEui=CHCr
MasterChatRderEui=CHCs
MasterEmoPnlEui=CHCt
MasterEui=CHCu
MasterMenuEui=CHCv
MasterMianEui=CHCw
MasterPrivChatEui=CHCx
MasterRadioEui=CHCy
MasterSenceEui=CHCz
MasterSettingEui=CHCA
MasterTitleEui=CHCB
MasterTitleRnd=CHCC
MasterTuDiRderEui=CHCD
MobaiRwdEui=CHCE
MtaskRnd=CHCF
socialTipsEui=CHCG
MazeBoxView=CHCH
MazeEvt=CHCI
MazeMdu=CHCJ
MazeVMed=CHCK
MazeConfig=CHCL
MazeMod=CHCM
MazePlyMod=CHCN
MazeArrow=CHCO
MazeAwdPnl=CHCP
MazeItemRender=CHCQ
MazeMainPnl=CHCR
MazeMainRtPnl=CHCS
MazeProg=CHCT
MazeTip=CHCU
MazeBoxVO=CHCV
MazeItemVO=CHCW
MazePlayer=CHCX
MazePortalVO=CHCY
MazeRoomChangeVo=CHCZ
MilitRkMdu=CHC1
MilitRkVMed=CHC2
MilitaryRankConfig=CHC3
MilitRkMod=CHDa
MilitRkLstV=CHDb
MilitRkV=CHDc
MilitRkLstRnd=CHDd
MilitRkIf=CHDe
MilitRkLst=CHDf
MilitRkPnl=CHDg
MilitaryRankListVO=CHDh
MoldingMod=CHDi
MoldingMdu=CHDj
MoldingMed=CHDk
MoldEui=CHDl
MoldingV=CHDm
MoldProEui=CHDn
MoldRound=CHDo
TipSkPal=CHDp
MoonMod=CHDq
MoonMdu=CHDr
MoonMed=CHDs
MoonV=CHDt
MoonCardRender=CHDu
MoonCardVo=CHDv
MoonEui=CHDw
NBiqiET=CHDx
NightBiqiStatic=CHDy
NBiqiMod=CHDz
NBiqiModCfg=CHDA
NBiqiPMod=CHDB
NBiqiMdu=CHDC
NBiqiMed=CHDD
NBiqiMMed=CHDE
NBiqiAPan=CHDF
NBiqiPan=CHDG
NBiqiRPan=CHDH
NBiqiAchP=CHDI
NBiqiCDP=CHDJ
NBiqiMAP=CHDK
NBiqiMEP=CHDL
NBiqiMEV=CHDM
NBiqiMP=CHDN
NBiqiMRP=CHDO
NBiqiRoP=CHDP
NightBuffItem=CHDQ
NBiqiBRed=CHDR
NBiqiGRed=CHDS
NBiqiMERed=CHDT
NBiqiARed=CHDU
NBiqiRkRed=CHDV
NBiqiRRed=CHDW
NightBiqiEndVo=CHDX
NightBiqiPointVO=CHDY
NightBiqiRankVo=CHDZ
NightBiqiRewardVo=CHD1
NightBuffVo=CHD2
NightScenePlayerVo=CHD3
OLMdu=CHEa
OlMed=CHEb
OffLineShare=CHEc
OLPan=CHEd
CZDecoMed=CHEe
CZMdu=CHEf
CZMed=CHEg
CZEvt=CHEh
CZCfgMod=CHEi
CZMod=CHEj
CZDecoAlert=CHEk
CZDecoRnd=CHEl
CZCQEquEui=CHEm
CZCQEquHefuEui=CHEn
CZDecoEui=CHEo
CZEui=CHEp
CZDecoVo=CHEq
CZEquStatic=CHEr
CZEquVo=CHEs
CZVo=CHEt
CZWearEquVo=CHEu
EqpAlertMed=CHEv
OtherPopMod=CHEw
OtherPopMdu=CHEx
SklAlertMed=CHEy
EquipAlertV=CHEz
EqpAlertEui=CHEA
MduAlertEui=CHEB
SklEqpEui=CHEC
MduAlertV=CHED
SkillAlertV=CHEE
PtnerET=CHEF
PtnerCMod=CHEG
PtnerMod=CHEH
PtnerMdu=CHEI
PtnerMed=CHEJ
PtnerV=CHEK
PartEui=CHEL
PtnerEui=CHEM
PartVo=CHEN
PtnerVo=CHEO
BackResponse=CHEP
ChangeAutoBoxRder=CHEQ
ChangeAutoPanel=CHER
ChangeAutoRder=CHES
HandUpBtn=CHET
HandUpStates=CHEU
lockMonState=CHEV
familyTrial=CHEW
wingBossStat=CHEX
mainBossStat=CHEY
HandType=CHEZ
ModuleCheckByTime=CHE1
ModuleCheckEvt=CHE2
ModuleIfDo=CHE3
ChangeAutoVo=CHFa
CRderVo=CHFb
ChangeJobInfoPanel=CHFc
ChangeJobNewRder=CHFd
ChangeJobOldRder=CHFe
ChangeJobPanel=CHFf
ChangeJobVo=CHFg
ItemCard=CHFh
CgPosPanel=CHFi
CgPosRender=CHFj
CgPosVo=CHFk
PlayerSetMdu=CHFl
PlayerSetMed=CHFm
CgLeadEui=CHFn
HeroInfoRd=CHFo
PlayerPosPanel=CHFp
PlayerPosRender=CHFq
PlayerSetEui=CHFr
PlayerSetV=CHFs
HeroInfoVo=CHFt
RolePosVo=CHFu
PlaysetEvt=CHFv
PlaySetMdu=CHFw
PlaySetMed=CHFx
PlaySetMod=CHFy
CailiaoRnd=CHFz
PayAlert=CHFA
PlaySetEui=CHFB
PlaySetEuiView=CHFC
SuprRender=CHFD
PlaySetItemEui=CHFE
PlaySetVo=CHFF
PortEvt=CHFG
PortMod=CHFH
PortMdu=CHFI
PortMed=CHFJ
PortMainV=CHFK
PortRankV=CHFL
PortRankRnd=CHFM
PortMainEui=CHFN
PortRank=CHFO
PortRewardEui=CHFP
PortChapterVO=CHFQ
PortRankVO=CHFR
PortShowVO=CHFS
PortVO=CHFT
PrisonEvent=CHFU
PrisonCfg=CHFV
PrisonMod=CHFW
PrisonMdu=CHFX
PrisonMed=CHFY
PrisonV=CHFZ
PrLogRd1=CHF1
PrnAlReEui=CHF2
PrnArtEui=CHF3
PrnItemEui=CHGa
PrnLogEui=CHGb
PrnLogRd=CHGc
PrnMainEui=CHGd
PrnRwAltEui=CHGe
PrnSelectRd=CHGf
PrnSltEui=CHGg
RankType=CHGh
RankET=CHGi
RankCfg=CHGj
RankMod=CHGk
RankMdu=CHGl
RankMed=CHGm
RRoleMed=CHGn
RankPan=CHGo
RankRed=CHGp
RankV=CHGq
RRoleV=CHGr
RankVO=CHGs
RZLVo=CHGt
ReRolCfg=CHGu
ReRolMod=CHGv
ReRolStatic=CHGw
ReRolMdu=CHGx
ReRollerMed=CHGy
RollGSRd=CHGz
RollListRd=CHGA
RollStaRd=CHGB
RollEui=CHGC
RollItemRd=CHGD
RollStarsEui=CHGE
RechargeRollerGetShowVo=CHGF
RechargeRollerStarStateVo=CHGG
RobotCap=CHGH
RobotMons=CHGI
RobotPlayer=CHGJ
RobotData=CHGK
RobotMdu=CHGL
RobotMod=CHGM
RoleEvt=CHGN
RebornCfgMod=CHGO
RebornMod=CHGP
RoleCfgMod=CHGQ
RoleMod=CHGR
RoleMdu=CHGS
RoleMed=CHGT
RbrankRwdRender=CHGU
RebornExpRnd=CHGV
RebornExpRndVo=CHGW
RebornRankRender=CHGX
RebornRealmRender=CHGY
RebornTaskLine=CHGZ
TeJieSJEui=CHG1
TeJieSJMgr=CHG2
TeJieVO=CHG3
HeroValueEui=CHHa
HeroValueMgr=CHHb
RebornV=CHHc
RoleV=CHHd
HeroEui=CHHe
MeridianEui=CHHf
RebornEui=CHHg
RebornExpEui=CHHh
RebornRankPanel=CHHi
RebornRealmPnl=CHHj
RebornRoadPanel=CHHk
RebornTaskPanel=CHHl
ReRankrwdEui=CHHm
RolePan=CHHn
WingDanEui=CHHo
WingEui=CHHp
CheckEquVo=CHHq
HeroLiRndVO=CHHr
RebornTaskInfoVo=CHHs
RoleStatic=CHHt
SCZBEvt=CHHu
SCZBStatic=CHHv
SCZBCfgMod=CHHw
SCZBMod=CHHx
SCZBPlayerMod=CHHy
SCZBSceneMod=CHHz
SCZBMainMed=CHHA
SCZBMdu=CHHB
SCZBMed=CHHC
SCZBMainEndRnd=CHHD
SCZBMainEnemyLiRnd=CHHE
SCZBMainPlyrRankRnd=CHHF
SCZBMainRankTimeRnd=CHHG
SCZBBociV=CHHH
SCZBMainCDClearAlertV=CHHI
SCZBMainEndV=CHHJ
SCZBMainEnemyV=CHHK
SCZBMainGuildRankV=CHHL
SCZBMainGuildStateV=CHHM
SCZBMainPlayerRankV=CHHN
SCZBMainRebornAlertV=CHHO
SCZBMainV=CHHP
SCZBRwdRnd=CHHQ
SCZBSelfScoreRwdRd=CHHR
SCZBAlertV=CHHS
SCZBEntryV=CHHT
SCZBGuildRankV=CHHU
SCZBGuildRwdV=CHHV
SCZBSelfRankV=CHHW
SCZBSelfRwdV=CHHX
SCZBV=CHHY
SCZBGuildVo=CHHZ
SCZBPlayerVo=CHH1
SCZBAckPlayerVo=CHH2
SCZBEndVo=CHH3
SCZBGHMemberVo=CHIa
SCZBGHRankVo=CHIb
SCZBKingVo=CHIc
SCZBLastGHRankVo=CHId
SCZBLastPlyrRankVo=CHIe
SCZBPlayerRankVo=CHIf
SCZBRankInTimeVo=CHIg
SCZBRwdFlyVo=CHIh
SCZBRwdVo=CHIi
SCZBScenePlayerVo=CHIj
GMEvt=CHIk
GMMdu=CHIl
GMMed=CHIm
LogVo=CHIn
GmV=CHIo
LabelRd=CHIp
GMEui=CHIq
ShareDataVo=CHIr
ShareGiftModel=CHIs
ShareRewardVo=CHIt
ShareGiftEvt=CHIu
ShareGiftMdu=CHIv
ShareGiftViewMed=CHIw
AddUpSharePanel=CHIx
AddUpShareRender=CHIy
ShareGiftPanel=CHIz
SLEvt=CHIA
BookCfgMod=CHIB
BookMod=CHIC
JiuJiModel=CHID
SHILIANTP=CHIE
SLMod=CHIF
SLMdu=CHIG
SLMed=CHIH
BookRndVo=CHII
BookTJRnd=CHIJ
JiuJiRender=CHIK
SLAwakeRnd=CHIL
SLBokCombineRnd=CHIM
SLBookDes=CHIN
SLBookDesVo=CHIO
SLBookRnd=CHIP
XFRnd=CHIQ
SLBookTJV=CHIR
SLBookV=CHIS
SLV=CHIT
BookSelAlert=CHIU
CJComp=CHIV
JiuJiCombinePanel=CHIW
JiuJiPanel=CHIX
SkillAwake=CHIY
SkillAwakeEffV=CHIZ
SkillEui=CHI1
SLBokCombineP=CHI2
SLBookP=CHI3
SLBookReplaceP=CHJa
SLBookSelP=CHJb
SLP=CHJc
ShopJson=CHJd
ShopMod=CHJe
ShopMdu=CHJf
ShopMed=CHJg
R_h=CHJh
R_m=CHJi
R_s=CHJj
R_t=CHJk
ShopV=CHJl
P_a=CHJm
P_c=CHJn
P_m=CHJo
P_n=CHJp
P_o=CHJq
P_s=CHJr
O_h=CHJs
O_m=CHJt
O_s=CHJu
O_t=CHJv
EqpCpVo=CHJw
SmeltMod=CHJx
SmeltMdu=CHJy
SmeltMed=CHJz
SmeltGrid=CHJA
SmeltSltRd=CHJB
SmeltV=CHJC
SmltEui=CHJD
SmltSltEui=CHJE
SltGVo=CHJF
SltSRVo=CHJG
ScConfig=CHJH
ScEvtType=CHJI
SclothUtil=CHJJ
ScModel=CHJK
SbagItemVo=CHJL
SbagVo=CHJM
SgeZiVo=CHJN
SpropVo=CHJO
SputVo=CHJP
SshopExpVo=CHJQ
SshopPriceVo=CHJR
SsoulPageVo=CHJS
StaskVo=CHJT
SoulClothesModule=CHJU
SoulClothesViewMediator=CHJV
SprBox=CHJW
SprBoxController=CHJX
SprEvtType=CHJY
SprBoxModel=CHJZ
SprPro=CHJ1
SoulChooseTip=CHJ2
SoulClothAlert=CHJ3
SoulClothesView=CHKa
SoulClothTipsView=CHKb
SoulMoveIcon=CHKc
SoulNumChoseAlert=CHKd
SoulResolveView=CHKe
SoulSuitTipView=CHKf
SoulCItemRder=CHKg
SoulClothGeZiRder=CHKh
SoulCShapeRder=CHKi
shapeVo=CHKj
SoulCSuitRder=CHKk
SoulDeconRder=CHKl
SouleResolveRder=CHKm
SoulPutIcon=CHKn
SoulSEliteRder=CHKo
SoulShopInfoRder=CHKp
SoulSPriceRder=CHKq
SoulTaskRder=CHKr
SoulTaskRecordRder=CHKs
STaskType=CHKt
SCAlertView=CHKu
SoulePriceAlertView=CHKv
SouleShopEliteDecom=CHKw
SouleShopInfoView=CHKx
SoulShopView=CHKy
SoulTabView=CHKz
SoulRecordAlertView=CHKA
SoulTaskResultView=CHKB
SoulTaskView=CHKC
SuperMod=CHKD
SuperMdu=CHKE
SuperMed=CHKF
SuperRd=CHKG
SuperEui=CHKH
SuperV=CHKI
SWBQEvt=CHKJ
SwbqCfgMod=CHKK
SwbqMgr=CHKL
SwbqMod=CHKM
SwbqDlgBub=CHKN
SwbqMo=CHKO
SwbqNpc=CHKP
SwbqPlayer=CHKQ
SwbqMdu=CHKR
SwbqMed=CHKS
SwbqGHSHRankRnd=CHKT
SwbqBossEnterV=CHKU
SwbqHurtRankV=CHKV
SwbqLblCellRnd=CHKW
SwbqProgressV=CHKX
SwbqRwdRnd=CHKY
SwbqRwdV=CHKZ
SwbqSideRwdV=CHK1
SwbqSideV=CHK2
SwbqBossVO=CHK3
SwbqGHRankVo=CHLa
SwbqRwdVO=CHLb
TaskET=CHLc
NPCMod=CHLd
TaskMod=CHLe
NpcDMed=CHLf
TaskMdu=CHLg
TaskMed=CHLh
GuajV=CHLi
NpcDV=CHLj
LvUpGPan=CHLk
NPCDPan=CHLl
OGJPan=CHLm
TaskPan=CHLn
TaskV=CHLo
TaskVo=CHLp
TestModel=CHLq
TestMdu=CHLr
TestMed=CHLs
TestRnd=CHLt
TestP=CHLu
TestV=CHLv
ModuleVO=CHLw
TitleEvt=CHLx
TitleCfg=CHLy
TitleMod=CHLz
TitleMdu=CHLA
TitleMed=CHLB
DressEui=CHLC
DressItemRD=CHLD
DressPropEui=CHLE
TitleEui=CHLF
TitleXqEui=CHLG
TitleV=CHLH
DressVo=CHLI
TitleAddVo=CHLJ
TitleloadVo=CHLK
TitleVo=CHLL
TreincEventType=CHLM
ITreincData=CHLN
TreincExpRenderVo=CHLO
videoEvt=CHLP
VideoGiftMod=CHLQ
VideoMdu=CHLR
VideoMed=CHLS
VideoGiftEui=CHLT
VideoRewardEui=CHLU
ReCData=CHLV
VipMod=CHLW
VStic=CHLX
VFAPRed=CHLY
VFPRed=CHLZ
VPRed=CHL1
VRVo=CHL2
VFAPan=CHL3
VFPPan=CHMa
VPan=CHMb
VPPan=CHMc
VipPV=CHMd
VipV=CHMe
VipMdu=CHMf
VipMed=CHMg
VipPMed=CHMh
VipGiftSvrMod=CHMi
VipGiftType=CHMj
VipGiftV=CHMk
VipGiftMdu=CHMl
VipGiftVMed=CHMm
WelfareMod=CHMn
WelfareStatic=CHMo
DaSnGdRd=CHMp
DaSnVo=CHMq
WelfGRd=CHMr
WelfGVo=CHMs
AcodeEui=CHMt
CheatEui=CHMu
CollectEui=CHMv
DaiSgnEui=CHMw
FAQEui=CHMx
NoticeEui=CHMy
SccEui=CHMz
SuspendPnl=CHMA
VQEui=CHMB
WelfEui=CHMC
WelfareV=CHMD
WelfVQVo=CHME
WelfareMdu=CHMF
WelfareMed=CHMG
CBZBMdu=CHMH
CBZBMed=CHMI
SBZBEvt=CHMJ
CBZBCfgMod=CHMK
CBZBMod=CHML
WingEquipStatic=CHMM
CBZBV=CHMN
CBZBRnd=CHMO
CBJNTipPnl=CHMP
CBJNTipPnl2=CHMQ
CBZBCvtPnl=CHMR
CBZBInfoPnl=CHMS
CBZBPnl=CHMT
ZhanLingVo=CHMU
ZlingCon=CHMV
ZlingMod=CHMW
ZlItemVo=CHMX
ZlLETe=CHMY
ZlingHCRen=CHMZ
ZlingRen=CHM1
ZlingartV=CHM2
ZlingComV=CHM3
ZlingRadEui=CHNa
ZlingMule=CHNb
ZlingViMed=CHNc
ZhuZET=CHNd
ZZCMod=CHNe
ZZMod=CHNf
ZZDui=CHNg
ZZEui=CHNh
ZZJEEui=CHNi
ZZJEui=CHNj
ZZUEui=CHNk
ZZV=CHNl
SuitStatic=CHNm
SuitVo=CHNn
ZZMdu=CHNo
ZZMed=CHNp
PlatFormStatic=CHNq
C_CAchieve_pullAllBonus=CHNr
C_CAchieve_pullBonus=CHNs
C_CActive_PullBox=CHNt
C_CActive_PullStore=CHNu
C_CActivityBonus=CHNv
C_CActivityUpdate=CHNw
C_CArrest_BuyHijacking=CHNx
C_CArrest_BuyRefreshCar=CHNy
C_CArrest_EscortOperation=CHNz
C_CArrest_GoImmediately=CHNA
C_CArrest_PanelRequest=CHNB
C_CArrest_ReceiveEndShow=CHNC
C_CArrest_ReceiveGrade=CHND
C_CArrest_RefreshCar=CHNE
C_CArrest_RequestMemberRank=CHNF
C_CArrest_RequestReddot=CHNG
C_CArrest_SnatchCar=CHNH
C_CArrest_SnatchCDClear=CHNI
C_CAuthorization_Suc=CHNJ
C_CBag_AddBag=CHNK
C_CBag_DecomposeEquip=CHNL
C_CBag_DecomposeLegendEquip=CHNM
C_CBag_MeltingEquip=CHNN
C_CBag_useItem=CHNO
C_CBag_UseSelectEquip=CHNP
C_CBag_UseSelectItem=CHNQ
C_CBegin_Watch=CHNR
C_CBigMoneyManMove=CHNS
C_CBook_Split=CHNT
C_CBossQuanMingInfo=CHNU
C_CBossRevive_fight=CHNV
C_CBossRevive_helpfight=CHNW
C_CBossRevive_invite=CHNX
C_CBossRevive_List=CHNY
C_CBossRevive_takereward=CHNZ
C_CBossRevive_targetInfo=CHN1
C_CBossSingleInfo=CHN2
C_CBossWingInfo=CHN3
C_CBossZhuanShengInfo=CHOa
C_CBuyLuckyShop_Item=CHOb
C_CChangeName_Suc=CHOc
C_CChangePlayerName=CHOd
C_CChat_Message=CHOe
C_CCheat_F9=CHOf
C_CCopyInfo=CHOg
C_CCrossboss_BuyChat=CHOh
C_CCrossboss_buycount=CHOi
C_CCrossboss_BuyTicket=CHOj
C_CCrossboss_challenge=CHOk
C_CCrossboss_dec=CHOl
C_CCrossboss_getstageInfo=CHOm
C_CCrossboss_info=CHOn
C_CCrossboss_invite=CHOo
C_CCrossboss_KillAims=CHOp
C_CCrossboss_login=CHOq
C_CCrossboss_LogInfo=CHOr
C_CCrossboss_loginout=CHOs
C_CCrossboss_revive=CHOt
C_CCrossboss_SingleFight=CHOu
C_CCrossboss_SingleInfo=CHOv
C_CCrossSandyCity_BuyTimes=CHOw
C_CCrossSandyCity_Entry=CHOx
C_CCrossSandyCity_FamilyBuyBuffsTimes=CHOy
C_CCrossSandyCity_FamilyFightInfo=CHOz
C_CCrossSandyCity_FamilyInspireBuffs=CHOA
C_CCrossSandyCity_InspireBuff=CHOB
C_CCrossSandyCity_Login=CHOC
C_CCrossSandyCity_PlayerStatus=CHOD
C_CCrossSandyCity_PrayLuck=CHOE
C_CCrossSandyCity_PrayLuckInfo=CHOF
C_CCrossSandyCity_Status=CHOG
C_CCrossSandyCity_WarInfo=CHOH
C_CCrossShop_Buy=CHOI
C_CCrossShop_PanelRequest=CHOJ
C_CDart_Clean_CD=CHOK
C_CDart_OneKeyGold=CHOL
C_CDart_Receive=CHOM
C_CDart_Receive_View=CHON
C_CDart_Record=CHOO
C_CDart_Refresh_Quality=CHOP
C_CDart_Revenge=CHOQ
C_CDart_Rob=CHOR
C_CDart_Start=CHOS
C_CDart_View=CHOT
C_CDebrisQuenching=CHOU
C_CDisciple_doBonus=CHOV
C_CDisciple_getinfo=CHOW
C_CDisciple_out=CHOX
C_CDisciple_searchMaster=CHOY
C_CDoBigMoneyManBonus=CHOZ
C_CDoDailySign=CHO1
C_CDoPromotionTask_Bonus_OneKey=CHO2
C_CDoPromotionTask_TargetBonus=CHO3
C_CDrawFestivalRecharge_Bonus=CHPa
C_CDrawOffLine_Bonus=CHPb
C_CDrawPromotioCrazyReCharge_Bonus=CHPc
C_CDrawPromotionTask_Bonus=CHPd
C_CDraw_functionBonus=CHPe
C_CEnd_Watch=CHPf
C_CEquipQuenching=CHPg
C_CExchangeCard=CHPh
C_CFabaoActivate=CHPi
C_CFabaoDispatch=CHPj
C_CFabaojingshiDuihuan=CHPk
C_CFabaoPartsActivate=CHPl
C_CFabaoPartsGet=CHPm
C_CFabaoPartsUpLevel=CHPn
C_CFabaoShopBuy=CHPo
C_CFabaoShopBuy_refreshitem=CHPp
C_CFabaoShopInfo=CHPq
C_CFabaoShopRefresh=CHPr
C_CFamilyCopy_BeginFight=CHPs
C_CFamilyCopy_BuyBuff=CHPt
C_CFamilyCopy_BuyEnterCounts=CHPu
C_CFamilyCopy_DrawScoreBonus=CHPv
C_CFamilyCopy_Enter=CHPw
C_CFamilyCopy_GetBuffInfo=CHPx
C_CFamilyCopy_GetInfo=CHPy
C_CFamilyCopy_GetScoreInfo=CHPz
C_CFamilyCopy_NextRound=CHPA
C_CFamilyCopy_RoundDefeat=CHPB
C_CFamilyCopy_RoundVictory=CHPC
C_CFamilyCopy_Victory=CHPD
C_CFamilyMagic_Dekaron=CHPE
C_CFamilyMagic_Rank=CHPF
C_CFamilyMagic_Sweep=CHPG
C_CFamilyMagic_View=CHPH
C_CFamily_AllotItem=CHPI
C_CFamily_ChangeName=CHPJ
C_CFamily_CheckJoin=CHPK
C_CFamily_Create=CHPL
C_CFamily_Donate=CHPM
C_CFamily_FightIntrusion=CHPN
C_CFamily_GetAllFamily=CHPO
C_CFamily_getPublicskill=CHPP
C_CFamily_getPublicskilldonate=CHPQ
C_CFamily_GrabRedPacket=CHPR
C_CFamily_Impeachment=CHPS
C_CFamily_Join=CHPT
C_CFamily_KickOut=CHPU
C_CFamily_Leaf=CHPV
C_CFamily_RedPacket=CHPW
C_CFamily_RequestList=CHPX
C_CFamily_SetJoinLimit=CHPY
C_CFamily_SetLeader=CHPZ
C_CFamily_SetNotice=CHP1
C_CFamily_SetOffer=CHP2
C_CFamily_ShopBuy=CHP3
C_CFamily_Study=CHQa
C_CFamily_takePublicskillReward=CHQb
C_CFamily_upPublicskill=CHQc
C_CFashion_Active=CHQd
C_CFashion_LevelUp=CHQe
C_CFashion_Put=CHQf
C_CFazhen_getinfo=CHQg
C_CFazhen_hecheng=CHQh
C_CFazhen_lingwuUpLevel=CHQi
C_CFazhen_upLevel=CHQj
C_CFestivalBox_ChangeState=CHQk
C_CFestivalBox_Obtain=CHQl
C_CFestivalBox_ReadyObtain=CHQm
C_CFightFigure_Decompose=CHQn
C_CFightFigure_Disassembly=CHQo
C_CFightFigure_Equip=CHQp
C_CFightFigure_LevelUp=CHQq
C_CFightFigure_OnKeyEquip=CHQr
C_CFightFigure_OnKeyLevelUp=CHQs
C_CFightFigure_Synthesis=CHQt
C_CFinal_MijiSkillInfo=CHQu
C_CFinal_MijiSkill_Replacement=CHQv
C_CFocus_Suc=CHQw
C_CGetActivityData=CHQx
C_CGetBigMoneyManInfo=CHQy
C_CGetBindPhone_Suc=CHQz
C_CGetCheat_Suc=CHQA
C_CGetCrossconsumetop=CHQB
C_CGetCrossconsumetop_openstate=CHQC
C_CGetFestivalRechargeInfo=CHQD
C_CGetLuckyShop_Info=CHQE
C_CGetPlayerHateInfo=CHQF
C_CGetPlayerHeroIndex=CHQG
C_CGetPlayerModuleShow=CHQH
C_CGetPromotioCrazyReChargeInfo=CHQI
C_CGetPromotionConfig=CHQJ
C_CGetPromotionConsumeRankInfo=CHQK
C_CGetPromotionConsumeRebateInfo=CHQL
C_CGetPromotionInfo=CHQM
C_CGetPromotionInfo_ById=CHQN
C_CGetPromotionLuckyFishInfo=CHQO
C_CGetPromotionTaskInfo=CHQP
C_CGetPromotioSingleRed_Charge_Info=CHQQ
C_CGetPromotioSingleRed_Info=CHQR
C_CGetPromotioSystemRed_Info=CHQS
C_CGetSpecialLogin_Suc=CHQT
C_CGetWatch_Info=CHQU
C_CGet_functionInfo=CHQV
C_CGet_ShareData=CHQW
C_CGuide_NextStep=CHQX
C_CGuid_Suc=CHQY
C_CHangUp_ButtonOn=CHQZ
C_CHangUp_Info=CHQ1
C_CHangUp_Open=CHQ2
C_CHangUp_Settings=CHQ3
C_CHero_ActivationSuit=CHRa
C_CHero_ActivationWing=CHRb
C_CHero_AddWingExp=CHRc
C_CHero_AdvancedSuit=CHRd
C_CHero_BackOutBook=CHRe
C_CHero_CastingSoul=CHRf
C_CHero_ChangeLeader=CHRg
C_CHero_ChangeShowWing=CHRh
C_CHero_ComposeLegend=CHRi
C_CHero_ComposeOrange=CHRj
C_CHero_EquipLegend=CHRk
C_CHero_EquipSoul=CHRl
C_CHero_EquipStone=CHRm
C_CHero_EquipStrong=CHRn
C_CHero_Fuling=CHRo
C_CHero_LevelUpAwakeSkill=CHRp
C_CHero_LevelUpBook=CHRq
C_CHero_LevelUpFinalBook=CHRr
C_CHero_LevelUpLongSoul=CHRs
C_CHero_LevelUpMeridian=CHRt
C_CHero_LevelUpRingBody=CHRu
C_CHero_LevelUpRingParalysis=CHRv
C_CHero_LevelUpShield=CHRw
C_CHero_LevelUpSkill=CHRx
C_CHero_LevelUpSkillAll=CHRy
C_CHero_LevelUpSuit=CHRz
C_CHero_LevelUpWing=CHRA
C_CHero_LevelUpWingByOne=CHRB
C_CHero_LoadEquip=CHRC
C_CHero_LvUpSoul=CHRD
C_CHero_NewRole=CHRE
C_CHero_OneKeyWingExp=CHRF
C_CHero_PowerSelect=CHRG
C_CHero_propInfo=CHRH
C_CHero_RecoveryFuling=CHRI
C_CHero_SplitSuit=CHRJ
C_CHero_StudyBook=CHRK
C_CHero_StudyFinalBook=CHRL
C_CHero_UpgradeLegend=CHRM
C_CHero_UpgradeToOrange=CHRN
C_CHero_WingUseElixir=CHRO
C_CHonor_Exchange=CHRP
C_CHonor_FamilyRank=CHRQ
C_CHonor_PlayerRank=CHRR
C_CInvestTurnTable_draw=CHRS
C_CInvestTurnTable_log=CHRT
C_CInvestTurnTable_View=CHRU
C_CInvite_getData=CHRV
C_CInvite_getRmb=CHRW
C_CInvite_relation=CHRX
C_CInvite_takeReward=CHRY
C_CKing_BuyCount=CHRZ
C_CKing_MatchTarget=CHR1
C_CKing_OnOpen=CHR2
C_CKing_RealChallenge=CHR3
C_CKing_ReceiveRankBonus=CHSa
C_CLogin_Create=CHSb
C_CLogin_Login=CHSc
C_CLotteryConsume_RankInfo=CHSd
C_CLottery_Activity=CHSe
C_CLottery_ActivityGetLogs=CHSf
C_CLottery_CrazyActivity=CHSg
C_CLottery_Extract=CHSh
C_CLottery_FestivalActivityGetLogs=CHSi
C_CLottery_GetLogs=CHSj
C_CLottery_PickUpAll=CHSk
C_CLottery_PickUpOne=CHSl
C_CLottery_PlantTree=CHSm
C_CLottery_PlantTreeGetLogs=CHSn
C_CLuckyTurnTable_Open=CHSo
C_CLuckyTurnTable_Start=CHSp
C_CMagic_LevelupMagicKungfu=CHSq
C_CMail_Delete=CHSr
C_CMail_GetFj=CHSs
C_CMail_GetFjs=CHSt
C_CMail_getMails=CHSu
C_CMail_readMail=CHSv
C_CMainCity_attack=CHSw
C_CMainCity_attmonster=CHSx
C_CMainCity_attmonster_rank=CHSy
C_CMainCity_Enter=CHSz
C_CMainCity_Exit=CHSA
C_CMainCity_exitMainMonster=CHSB
C_CMainCity_getEnvent=CHSC
C_CMainCity_getPlayersInfo=CHSD
C_CMainCity_getPlayerstate=CHSE
C_CMainCity_HateAddbuff=CHSF
C_CMainCity_hurtInfo=CHSG
C_CMainCity_MonsterInfo=CHSH
C_CMainCity_Move=CHSI
C_CMainCity_reborn=CHSJ
C_CMainCity_recover=CHSK
C_CMainCity_selectEnvent=CHSL
C_CMaster_GetFirstDisciple=CHSM
C_CMaster_getinfo=CHSN
C_CMaster_GetStates=CHSO
C_CMaster_moBai=CHSP
C_CMaster_out=CHSQ
C_CMaster_resureReq=CHSR
C_CMaster_sendMessage=CHSS
C_CMazeBeforePickUpBox=CHST
C_CMazeBuyItem=CHSU
C_CMazeClickTransmissionGate=CHSV
C_CMazeEnter=CHSW
C_CMazeLeaveRoom=CHSX
C_CMazeMove=CHSY
C_CMazePickUpBox=CHSZ
C_CMazeUseItem=CHS1
C_CMeet_BuyRevengeCount=CHS2
C_CMeet_GetRevenges=CHS3
C_CMeet_GetSelfMeetRank=CHTa
C_CMenpaiCross_battle=CHTb
C_CMenpaiCross_EndBattle=CHTc
C_CMenpaiCross_EndTransmit=CHTd
C_CMenpaiCross_GetItem=CHTe
C_CMenpaiCross_login=CHTf
C_CMenpaiCross_loginout=CHTg
C_CMenpaiCross_Move=CHTh
C_CMenpaiCross_PlayerInfos=CHTi
C_CMenpaiCross_sendgif=CHTj
C_CMenpaiCross_setting=CHTk
C_CMenpaiCross_Transmit=CHTl
C_CMenpaiCross_TransmitReply=CHTm
C_CMenpaiCross_TransmitReward=CHTn
C_CMenpai_info=CHTo
C_CMenpai_login=CHTp
C_CMergerActivityBonus=CHTq
C_CMergerSingle_AddTimesByManual=CHTr
C_CMergerSingle_FindEnemy=CHTs
C_CMergerSingle_GetDailyBonus=CHTt
C_CMergerSingle_GetStageBonus=CHTu
C_CMergerSingle_GetView=CHTv
C_CMergerSingle_RealFight=CHTw
C_CMergerSingle_WeekRankView=CHTx
C_CMijiSkill_Replacement=CHTy
C_CModule_GetBonus=CHTz
C_CMultiAttack=CHTA
C_CMultiField_cancelOwner=CHTB
C_CMultiField_CollectFinish=CHTC
C_CMultiField_CollectItem=CHTD
C_CMultiField_Enter=CHTE
C_CMultiField_GetItem=CHTF
C_CMultiField_Leave=CHTG
C_CMultiField_PlayerInfos=CHTH
C_CMultiMove=CHTI
C_CNationalDayLottery_Activity=CHTJ
C_CNextTime_Start=CHTK
C_CNightBiQi_Attack=CHTL
C_CNightBiQi_AttackMonster=CHTM
C_CNightBiQi_AutoReborn=CHTN
C_CNightBiQi_BuffAddition=CHTO
C_CNightBiQi_Enter=CHTP
C_CNightBiQi_Move=CHTQ
C_CNightBiQi_Pick=CHTR
C_CNightBiQi_PlayerInfos=CHTS
C_CNightBiQi_PlayerRank=CHTT
C_CNightBiQi_Reborn=CHTU
C_CNightBiQi_ScoreReward=CHTV
C_CPlayerAllInfo=CHTW
C_CPlayerFabaoInfo=CHTX
C_CPlayerFabaoUpLvOrUpStar=CHTY
C_CPlayerGetAchievementRewardInfo=CHTZ
C_CPlayerLookFunction=CHT1
C_CPlayerModuleShow=CHT2
C_CPlayerOtherModeInfo=CHT3
C_CPlayerPrivilegeCardInfo=CHUa
C_CPlayerTakeAchievementReward=CHUb
C_CPlayerUpdateHeroAttIndex=CHUc
C_CPlayerUpdateHeroIndex=CHUd
C_CPlayerUpdateHeroJobIndex=CHUe
C_CPlayer_BuyMonthCard=CHUf
C_CPlayer_LevelUpMedal=CHUg
C_CPlayer_UpdateTask=CHUh
C_CPromotionBonus=CHUi
C_CPromotionChargeBuy_draw=CHUj
C_CPromotionChargeBuy_View=CHUk
C_CPromotionConsumeRebate_draw=CHUl
C_CPromotionConsumeRebate_View=CHUm
C_CPromotionContinueCharge_draw=CHUn
C_CPromotionContinueCharge_View=CHUo
C_CPromotionDaily_draw=CHUp
C_CPromotionDaily_View=CHUq
C_CPromotionLuckyTurn_draw=CHUr
C_CPromotionLuckyTurn_log=CHUs
C_CPromotionLuckyTurn_View=CHUt
C_CPromotionRewardTurn_draw=CHUu
C_CPromotionRewardTurn_View=CHUv
C_CPromotionSpecialDaily_draw=CHUw
C_CPromotionSpecialDaily_FightBoss=CHUx
C_CPromotionSpecialDaily_View=CHUy
C_CPromotionSpecial_AddBonus=CHUz
C_CPromotionSpecial_DrawBonus=CHUA
C_CPromotionSpecial_DrawTargetBonus=CHUB
C_CPromotionSpecial_Info=CHUC
C_CPromotioSingleRed_Charge_Draw=CHUD
C_CPromotioSingleRed_Record=CHUE
C_CPromotioSingleRed_Send=CHUF
C_CPromotioSingleRed_Take=CHUG
C_CPromotioSystemRed_Take=CHUH
C_CProtect_Boss_Fight=CHUI
C_CProtect_enter=CHUJ
C_CProtect_quickReborn=CHUK
C_CProtect_Soilder_Fight=CHUL
C_CProtect_Soilder_Rank=CHUM
C_CProtect_Soilder_Reward=CHUN
C_CRankInfo=CHUO
C_CRankPlayerInfo=CHUP
C_CRankWorship=CHUQ
C_CRewardCenter_Data=CHUR
C_CSandyCity_Attack=CHUS
C_CSandyCity_AttackMonster=CHUT
C_CSandyCity_BuffAddition=CHUU
C_CSandyCity_DailyReward=CHUV
C_CSandyCity_Enter=CHUW
C_CSandyCity_Entry=CHUX
C_CSandyCity_FamilyRank=CHUY
C_CSandyCity_FamilyState=CHUZ
C_CSandyCity_LastFamilyRank=CHU1
C_CSandyCity_LastPlayerRank=CHU2
C_CSandyCity_Move=CHU3
C_CSandyCity_NextField=CHVa
C_CSandyCity_PlayerInfos=CHVb
C_CSandyCity_PlayerRank=CHVc
C_CSandyCity_Reborn=CHVd
C_CSandyCity_ScoreReward=CHVe
C_CSandyCity_StatusFight=CHVf
C_CScene_CallBoss=CHVg
C_CScene_ChapterBonus=CHVh
C_CScene_Circle=CHVi
C_CScene_Copy=CHVj
C_CScene_CopyNextRound=CHVk
C_CScene_EndBattle=CHVl
C_CScene_EnterSummonBoss=CHVm
C_CScene_GetCopyCountsInfo=CHVn
C_CScene_GetCopyCountsRewad=CHVo
C_CScene_InCityGetBonus=CHVp
C_CScene_LeafScene=CHVq
C_CScene_LotteryOk=CHVr
C_CScene_MainBoss=CHVs
C_CScene_MeetBoss=CHVt
C_CScene_MeetFight=CHVu
C_CScene_MeetReport=CHVv
C_CScene_NewTown=CHVw
C_CScene_NextRound=CHVx
C_CScene_PrivilegeCopyNextRound=CHVy
C_CScene_QaunMingAttention=CHVz
C_CScene_QaunMingKillLog=CHVA
C_CScene_QuanMingAddBuff=CHVB
C_CScene_QuanmingBoss=CHVC
C_CScene_QuanMingChallenge=CHVD
C_CScene_QuanMingRank=CHVE
C_CScene_RevengeMeet=CHVF
C_CScene_SearchMeet=CHVG
C_CScene_SingleBoss=CHVH
C_CScene_SingleBossSweep=CHVI
C_CScene_SpringFestivalBoss=CHVJ
C_CScene_SpringFestivalBoss_reward=CHVK
C_CScene_SummonBossForHelp=CHVL
C_CScene_TakeBonus=CHVM
C_CScene_Zhuansheng=CHVN
C_CScene_ZhuanshenRevive=CHVO
C_CScene_ZSRankInfo=CHVP
C_CSendIndex=CHVQ
C_CSendRechargeInfo=CHVR
C_CShareActivityHappy_BuyItem=CHVS
C_CShareActivityHappy_Draw=CHVT
C_CShareActivityHappy_GetInfo=CHVU
C_CShareActivityHappy_NextRound=CHVV
C_CShareActivityHappy_Start=CHVW
C_CShareActivityHappy_UseItem=CHVX
C_CShareActivityJiZan_GetInfo=CHVY
C_CShareActivity_AddScore=CHVZ
C_CShareActivity_BeginGame=CHV1
C_CShareActivity_ClickFriend=CHV2
C_CShareActivity_Draw=CHV3
C_CShareActivity_GetDefenderInfo=CHWa
C_CShareActivity_GetEatInfo=CHWb
C_CShareActivity_GetLogs=CHWc
C_CShareActivity_GetRandomReward=CHWd
C_CShareActivity_GetServerRank=CHWe
C_CShareActivity_Info=CHWf
C_CShare_DoubleBonus=CHWg
C_CShare_InviteSuc=CHWh
C_CShare_Sucess=CHWi
C_CShare_TakeReward=CHWj
C_CShare_TuYouKeFu=CHWk
C_CShoppingMall_Buy=CHWl
C_CShop_BuyItem=CHWm
C_CShop_BuyMysteryItem=CHWn
C_CShop_FlusMysteryItem=CHWo
C_CShop_GetMysteryItem=CHWp
C_CShop_showShopView=CHWq
C_CSky_Sky=CHWr
C_CSky_Sky_Activate=CHWs
C_CSky_Sky_Tupo=CHWt
C_CSky_Transition=CHWu
C_CSoulEquip_Info=CHWv
C_CSoulEquip_Move=CHWw
C_CSoulEquip_OpenGrid=CHWx
C_CSoulEquip_Recycling=CHWy
C_CSoulEquip_Unload=CHWz
C_CSoulEquip_Wear=CHWA
C_CSoulShop_AuctionBuy=CHWB
C_CSoulShop_AuctionDetail=CHWC
C_CSoulShop_DirectBuy=CHWD
C_CSoulShop_EssenceBuy=CHWE
C_CSoulShop_HistoryPrice=CHWF
C_CSoulShop_Request=CHWG
C_CSoulTask_BuyReceive=CHWH
C_CSoulTask_BuyReel=CHWI
C_CSoulTask_Info=CHWJ
C_CSoulTask_Operating=CHWK
C_CSoulTask_Refresh=CHWL
C_CSummonBossAllInfo=CHWM
C_CSYaoTower_AddBuff=CHWN
C_CSYaoTower_buy=CHWO
C_CSYaoTower_buySweep=CHWP
C_CSYaoTower_Challenge=CHWQ
C_CSYaoTower_getInfo=CHWR
C_CSYaoTower_OpenView=CHWS
C_CSYaoTower_Sweep=CHWT
C_CSystem_GetVesion=CHWU
C_CSystem_HB=CHWV
C_CTakeActivityRward=CHWW
C_CTask_TakeBonus=CHWX
C_CThunderEquip_Convert=CHWY
C_CThunderEquip_cuiqu=CHWZ
C_CThunderEquip_cuiquLock=CHW1
C_CThunderEquip_getBaginfo=CHW2
C_CThunderEquip_getinfo=CHW3
C_CThunderEquip_resolve=CHXa
C_CThunderEquip_taozhuangActivate=CHXb
C_CThunderEquip_taozhuangTupo=CHXc
C_CThunderEquip_taozhuangUpLv=CHXd
C_CThunderEquip_zizhuangAllWear=CHXe
C_CThunderEquip_zizhuangWear=CHXf
C_CTitle_load=CHXg
C_CTitle_Unload=CHXh
C_CTongtianBattlefield_Attack=CHXi
C_CTongtianBattlefield_AttackMonster=CHXj
C_CTongtianBattlefield_BuyItem=CHXk
C_CTongtianBattlefield_End_GatherBox=CHXl
C_CTongtianBattlefield_Enter=CHXm
C_CTongtianBattlefield_GatherBox=CHXn
C_CTongtianBattlefield_Interrupt_GatherBox=CHXo
C_CTongtianBattlefield_Move=CHXp
C_CTongtianBattlefield_PlayerInfos=CHXq
C_CTongtianBattlefield_PlayerRank=CHXr
C_CTongtianBattlefield_Reborn=CHXs
C_CTongtianBattlefield_TakeReward=CHXt
C_CTurnTable_Extract=CHXu
C_CTurnTable_GetLogs=CHXv
C_CTurnTable_Open=CHXw
C_CTuYou_SignStates=CHXx
C_CValhallaAnimalLevelUp=CHXy
C_CValhallaInfo=CHXz
C_CValhallaSynthesis=CHXA
C_CValhallaWeaponLevelUp=CHXB
C_CVipGiftActivityInfo=CHXC
C_CVipGift_Bonus=CHXD
C_CVip_GetVipBonus=CHXE
C_CVip_HideVip=CHXF
C_CWingEquip_ChangePos=CHXG
C_CWingEquip_LevelUpEquip=CHXH
C_CWingEquip_LevelUpEquipInPos=CHXI
C_CWingEquip_OnKeyEquip=CHXJ
C_CXiuwei_rewardinfoget=CHXK
C_CXiuwei_rewardtake=CHXL
C_CZhuanshengtask_infoget=CHXM
C_CZhuanshengtask_rewardtake=CHXN
C_CZhuanshengtask_uplv=CHXO
C_CZhuansheng_AddExp=CHXP
C_CZhuansheng_Zhuansheng=CHXQ
C_C_ActivationArtifacts=CHXR
C_C_LevelUpArtifacts=CHXS
MessageId=CHXT
NetSender=CHXU
ACarGotoPlayerInfo=CHXV
AchieveState=CHXW
ActionData=CHXX
ActiveTask=CHXY
ActiveTaskData=CHXZ
ActivityInfo=CHX1
ActivityRankValue=CHX2
ActivityServerProcessData=CHX3
AFamilyCarRewardInfo=CHYa
ArrestCarInfo=CHYb
ArrestCarlogInfo=CHYc
ArrestFamilyRankInfo=CHYd
ArrestGradeInfo=CHYe
ArrestHitInfo=CHYf
ArrestMemberRankInfo=CHYg
ArrestPlayerlogInfo=CHYh
ArrestPlayerRankInfo=CHYi
ArtifactsData=CHYj
BackActivitySingleDataVo=CHYk
BattleAddition=CHYl
BattlePassiveSkill=CHYm
BattleSkill=CHYn
BigMoneyManVo=CHYo
BonusData=CHYp
BossQuanMingObj=CHYq
BossrevengeInviteInfo=CHYr
BossRevengeVO=CHYs
BossSingleObj=CHYt
BoxData=CHYu
BuffChange=CHYv
CenterKingWeekData=CHYw
ChatData=CHYx
ChatVO=CHYy
ClientTitleData=CHYz
ConsumeRankInfo=CHYA
CountData=CHYB
CrossBossInviteInfo=CHYC
CrossBosslogInfo=CHYD
CrossBossTicketInfo=CHYE
CrossCityFightPlayerResult=CHYF
CrossCityPrayLuckFamilyInfo=CHYG
CrossShopInfo=CHYH
DartVo=CHYI
DiscipleInfo=CHYJ
EquipBoxData=CHYK
EscortCarInfo=CHYL
EscortPlayerInfo=CHYM
EscortRecord=CHYN
FabaoInfo=CHYO
FabaoPartsInfo=CHYP
FabaoshopIteminfo=CHYQ
FamilyBuyCountData=CHYR
FamilyBuyData=CHYS
FamilyCopyBoss=CHYT
FamilyCopyBuffInfoVo=CHYU
FamilyCopyBuffItemVo=CHYV
FamilyCopyCallBuffVo=CHYW
FamilyCopyHeroInfoVo=CHYX
FamilyCopyNormalBuffVo=CHYY
FamilyCopyScoreInfoVo=CHYZ
FamilyData=CHY1
FamilyInfo=CHY2
FamilyLog=CHY3
FamilyMemberData=CHZa
FamilyMemberSkillInfo=CHZb
FamilyRed=CHZc
FamilyRedLog=CHZd
FamilySkillData=CHZe
FamilySkillInfo=CHZf
FamilyStorageItem=CHZg
FamilyStorageUseLog=CHZh
FashionVo=CHZi
FazhenLevelDataDTO=CHZj
FazhenLingwuDataDTO=CHZk
FestivalBoxDetails=CHZl
FestivalBoxDisappear=CHZm
FightData=CHZn
FunctionInfoVo=CHZo
HeroData=CHZp
HeroFazhenData=CHZq
HeroFightFigureEquip=CHZr
HeroFuling=CHZs
HeroPropData=CHZt
HeroSkyEquip=CHZu
HeroThunderDataDTO=CHZv
HeroWingEquip=CHZw
HonorRankFamilyInfo=CHZx
HonorRankPlayInfo=CHZy
HpChange=CHZz
InvestTurnTableLogVo=CHZA
ItemBuyVo=CHZB
JoinHero=CHZC
JoinPlayer=CHZD
JoinRequestInfo=CHZE
KeyValueElement1=CHZF
KeyValueElement2=CHZG
KingCheckVO=CHZH
KingData=CHZI
KingDataVO=CHZJ
KingRankData=CHZK
LotteryLogVO=CHZL
LuckTurntableInfo=CHZM
LunHuiData=CHZN
MailVO=CHZO
MainCityHeroHp=CHZP
MainCityPlayer=CHZQ
MainmonsterPlayerRankItem=CHZR
Mainmonster_RankInTimeContent=CHZS
MapIntElement=CHZT
MasterChatMessageVo=CHZU
MazeBox=CHZV
MeetLogData=CHZW
MemberInfo=CHZX
MenpaiDropItemInfo=CHZY
MenpaiPlayer=CHZZ
MenpaiPlayerSimpleInfo=CHZ1
MeridianData=CHZ2
MultiActionData=CHZ3
MultiAttackInfo=CH1a
MultiAttackMonsterData=CH1b
MultiBloodData=CH1c
MultiBuffInfo=CH1d
MultiDropItemInfo=CH1e
MultiHeroDecHp=CH1f
MultiHeroInfo=CH1g
MultiHurtInfo=CH1h
MultiMonsterInfo=CH1i
MultiMove=CH1j
MultiPlayerInfo=CH1k
MultiSimpleInfo=CH1l
NightBiQiPlayerRankItem=CH1m
NightBiQiPointChange=CH1n
NightBiQiSimplePlayerItem=CH1o
NightBiQi_RankInTimeContent=CH1p
NoticeVO=CH1q
OtherFamilyInfo=CH1r
PassiveData=CH1s
PetInfo=CH1t
PlayerCrossTopInfo=CH1u
PlayerData=CH1v
PlayerInspireInfo=CH1w
PlayerInviteSimpleInfo=CH1x
PosEquip=CH1y
PromotionLuckyFishVo=CH1z
PromotionLuckyTurnLogVo=CH1A
PromotionRewardTurnLogVo=CH1B
PromotionSpecialDailyInfoVo=CH1C
PromotionTaskVo=CH1D
PromotionVo=CH1E
PromotioSingleRedVo=CH1F
ProtectPlayerInfo=CH1G
QuanMingAttentionInfo=CH1H
QuanMingData=CH1I
RankFirstInfo=CH1J
RankItem=CH1K
RankSingleData=CH1L
RevengeVO=CH1M
RobRecord=CH1N
SandyCityFamilyMemberItem=CH1O
SandyCityFamilyRankItem=CH1P
SandyCityPlayerRankItem=CH1Q
SandyCityPlayerTargetItem=CH1R
SandyCitySimpleHeroInfo=CH1S
SandyCity_RankInTimeContent=CH1T
SandyFamilyPlayer=CH1U
SandySimplePlayerItem=CH1V
SCrossSandyCityFamilyInfo=CH1W
ShareEatLogVo=CH1X
ShareEatVo=CH1Y
ShareJiZanVo=CH1Z
SharePlayerVo=CH11
ShopItemVO=CH12
ShopPermitItem=CH13
SimpleHeroInfo=CH2a
SimpleOtherPlayerInfo=CH2b
SimplePlayerFightInfo=CH2c
SimplePlayerInfo=CH2d
SimplePlayerItem=CH2e
SingleRedTakeDetail=CH2f
SkyBox=CH2g
SnatchDieInfo=CH2h
SoulAuctionDetail=CH2i
SoulAuctionItem=CH2j
SoulAuctionPerItem=CH2k
SoulEquipBoxInfo=CH2l
SoulItemExcInfo=CH2m
SoulTaskInfo=CH2n
SpecialBonusInfoVo=CH2o
StorageData=CH2p
SummonBossState=CH2q
SummonData=CH2r
SYaoTowerDataInfo=CH2s
TaskInfo=CH2t
TaskVO=CH2u
ThunderBoxDTO=CH2v
ThunderCuiquDataDTO=CH2w
ThunderCuiquGridDataDTO=CH2x
ThunderEquipDTO=CH2y
ThunderTaozhuangDataDTO=CH2z
ThunderZizhuangDataDTO=CH2A
TongtianBattlefieldBoxInfo=CH2B
TongtianBattlefieldPlayerRankItem=CH2C
TongtianBattlefieldSimplePlayerItem=CH2D
TongtianBattlefield_RankInTimeContent=CH2E
TurnTableLogVO=CH2F
ValhallaInfo=CH2G
WingData=CH2H
ZhuanShengData=CH2I
ZhuanShengScoreObj=CH2J
ZhuanshengTask=CH2K
S_SAccountBlocked=CH2L
S_SAchieve_LevelupKnighthood=CH2M
S_SActiveTaskStateChange=CH2N
S_SActive_OnActiveChange=CH2O
S_SActivityGetBonusSuc=CH2P
S_SActivityUpdate=CH2Q
S_SArrest_EscortCarInfo=CH2R
S_SArrest_EscortEndShow=CH2S
S_SArrest_EscortOperationRet=CH2T
S_SArrest_FamilyLogInfo=CH2U
S_SArrest_FamilyRankInfo=CH2V
S_SArrest_LoginInfo=CH2W
S_SArrest_OneCarInfo=CH2X
S_SArrest_PlayerLogInfo=CH2Y
S_SArrest_PlayerRankInfo=CH2Z
S_SArrest_RequestMemberRank=CH21
S_SArrest_RequestReddotRet=CH22
S_SArrest_SnatchCarInfo=CH23
S_SArrest_SnatchPersonalInfo=CH3a
S_SArrest_SnatchSpikeShow=CH3b
S_SBackActivityNextDay=CH3c
S_SBackActivityTake=CH3d
S_SBackActivityUpdate=CH3e
S_SBackPlayer=CH3f
S_SBag_AddBag=CH3g
S_SBag_BoxChanges=CH3h
S_SBag_EquipChanges=CH3i
S_SBag_FightFigureEquip=CH3j
S_SBag_MeltingEquip=CH3k
S_SBeginWatch_Suc=CH3l
S_SBigMoneyManActivityUpdate=CH3m
S_SBigMoneyMan_DoBonus=CH3n
S_SBossAllInfo=CH3o
S_SBossCallReward=CH3p
S_SBossHudunInfo=CH3q
S_SBossMeetInfo=CH3r
S_SBossQuanMingInfos=CH3s
S_SBossQuanMingReward=CH3t
S_SBossRevive_List=CH3u
S_SBossRevive_takereward=CH3v
S_SBossRevive_targetInfo=CH3w
S_SBossSingleInfos=CH3x
S_SBossWingInfo=CH3y
S_SBossZhuanShengReward=CH3z
S_SBossZhuanshgeng=CH3A
S_SChangePlayerName=CH3B
S_SChat_ChatMessage=CH3C
S_SChat_CloseTalk=CH3D
S_SChat_Messages=CH3E
S_SChat_Notice=CH3F
S_SChop_Data=CH3G
S_SClientStateGet=CH3H
S_SCopyCount=CH3I
S_SCopyInfo=CH3J
S_SCountDataChange=CH3K
S_SCrossboss_BuyChat=CH3L
S_SCrossboss_BuyTicket=CH3M
S_SCrossboss_challenge=CH3N
S_SCrossboss_decStamina=CH3O
S_SCrossboss_info=CH3P
S_SCrossboss_KillAims=CH3Q
S_SCrossboss_KillRewardTip=CH3R
S_SCrossboss_LogInfo=CH3S
S_SCrossboss_rewardget=CH3T
S_SCrossboss_SingleInfo=CH3U
S_SCrossSandyCity_BuyTimes=CH3V
S_SCrossSandyCity_Entry=CH3W
S_SCrossSandyCity_FamilyBuyBuffsTimes=CH3X
S_SCrossSandyCity_FamilyFightInfo=CH3Y
S_SCrossSandyCity_FamilyInspireBuffs=CH3Z
S_SCrossSandyCity_InspireBuff=CH31
S_SCrossSandyCity_PlayerStatus=CH32
S_SCrossSandyCity_PrayLuckInfo=CH33
S_SCrossSandyCity_Status=CHbaa
S_SCrossSandyCity_WarInfo=CHbab
S_SCrossShop_BuyRet=CHbac
S_SCrossShop_ShopInfo=CHbad
S_SDailySignData=CHbae
S_SDart_Clean_CD=CHbaf
S_SDart_OneKeyGold=CHbag
S_SDart_Receive=CHbah
S_SDart_ReceiveView=CHbai
S_SDart_Record=CHbaj
S_SDart_RedPoint=CHbak
S_SDart_Refresh_Quality=CHbal
S_SDart_Revenge=CHbam
S_SDart_Rob=CHban
S_SDart_Start=CHbao
S_SDart_View=CHbap
S_SDebrisQuenching=CHbaq
S_SDisciple_doBonus=CHbar
S_SDisciple_finishTasks=CHbas
S_SDisciple_FirstDisciple=CHbat
S_SDisciple_GetStates=CHbau
S_SDisciple_info=CHbav
S_SDisciple_out=CHbaw
S_SDisciple_searchMaster=CHbax
S_SDisciple_searchMasterResure=CHbay
S_SDisConfigChange=CHbaz
S_SEquipQuenching=CHbaA
S_SFabaoActivate=CHbaB
S_SFabaojingshiDuihuan=CHbaC
S_SFabaoPartsGet=CHbaD
S_SFabaoShopBuy_refreshitem=CHbaE
S_SFabaoShopInfo=CHbaF
S_SFamilyCopy_AllBuffChange=CHbaG
S_SFamilyCopy_BuffInfo=CHbaH
S_SFamilyCopy_BuyBuff=CHbaI
S_SFamilyCopy_BuyCallBuff_Suc=CHbaJ
S_SFamilyCopy_BuyEnterSucess=CHbaK
S_SFamilyCopy_DrawSucess=CHbaL
S_SFamilyCopy_EnterSucess=CHbaM
S_SFamilyCopy_FightEnter=CHbaN
S_SFamilyCopy_Info=CHbaO
S_SFamilyCopy_RoundInfo=CHbaP
S_SFamilyCopy_RoundVictoryInfo=CHbaQ
S_SFamilyCopy_ScoreInfo=CHbaR
S_SFamilyMagic_View=CHbaS
S_SFamily_AddMember=CHbaT
S_SFamily_AlotItemSuc=CHbaU
S_SFamily_BuyData=CHbaV
S_SFamily_ChangeName=CHbaW
S_SFamily_CheckJoinOk=CHbaX
S_SFamily_CheckList=CHbaY
S_SFamily_CreateOK=CHbaZ
S_SFamily_Exit=CHba1
S_SFamily_FamilyData=CHba2
S_SFamily_FamilyInfo=CHba3
S_SFamily_GetAllFamilys=CHbba
S_SFamily_getPublicskill=CHbbb
S_SFamily_getPublicskilldonate=CHbbc
S_SFamily_GrabRedPacketSuc=CHbbd
S_SFamily_InstrusionData=CHbbe
S_SFamily_LeaderChange=CHbbf
S_SFamily_LeafOk=CHbbg
S_SFamily_LevelChange=CHbbh
S_SFamily_MemberData=CHbbi
S_SFamily_MemberLeaf=CHbbj
S_SFamily_MemberSkillChange=CHbbk
S_SFamily_MemberUpdate=CHbbl
S_SFamily_NoticeChange=CHbbm
S_SFamily_RedData=CHbbn
S_SFamily_RedLog=CHbbo
S_SFamily_RequestListForFamily=CHbbp
S_SFamily_RequestListForPlayer=CHbbq
S_SFamily_RequestOk=CHbbr
S_SFamily_RequstSizeChange=CHbbs
S_SFamily_SelfInstrusionCount=CHbbt
S_SFamily_SelfVoteChange=CHbbu
S_SFamily_SendRedPacketSuc=CHbbv
S_SFamily_SetJoinLimit=CHbbw
S_SFamily_SetOderOK=CHbbx
S_SFamily_ShopData=CHbby
S_SFamily_StorageData=CHbbz
S_SFamily_StorageGoldChange=CHbbA
S_SFamily_StorageItemChange=CHbbB
S_SFamily_StorageLogChange=CHbbC
S_SFamily_TaskDatas=CHbbD
S_SFashion_Active=CHbbE
S_SFashion_Active2=CHbbF
S_SFashion_LevelUp=CHbbG
S_SFashion_Put=CHbbH
S_SFashion_Remove=CHbbI
S_SFazhen_getinfo=CHbbJ
S_SFazhen_hecheng=CHbbK
S_SFestivalBox_AutoDisappear=CHbbL
S_SFestivalBox_ChangeState=CHbbM
S_SFestivalBox_Obtain=CHbbN
S_SFestivalBox_ReadyObtain=CHbbO
S_SFestivalBox_Show=CHbbP
S_SFestivalBox_UseBoxToken=CHbbQ
S_SFestivalRecharge_Update=CHbbR
S_SFightFigure_Synthesis=CHbbS
S_SFight_BoxChanges=CHbbT
S_SFinalMiji_ReplacementSuc=CHbbU
S_SFinal_MijiSkillInfo=CHbbV
S_SGetCrossconsumetop=CHbbW
S_SGetCrossconsumetop_openstate=CHbbX
S_SGetPlayerHateInfo=CHbbY
S_SGuide_StateChange=CHbbZ
S_SHangUp_Info=CHbb1
S_SHero_ActivationWing=CHbb2
S_SHero_AddWingExp=CHbb3
S_SHero_AwakeSkill=CHbca
S_SHero_CastingSoul=CHbcb
S_SHero_ChangeLeader=CHbcc
S_SHero_ChangeWingShow=CHbcd
S_SHero_EquipSky=CHbce
S_SHero_EquipSoul=CHbcf
S_SHero_EquipStone=CHbcg
S_SHero_EquipStrong=CHbch
S_SHero_LevelUpMeridian=CHbci
S_SHero_LevelUpOtherEquip=CHbcj
S_SHero_LevelUpWing=CHbck
S_SHero_LoadEquip=CHbcl
S_SHero_LoginFightFigureEquips=CHbcm
S_SHero_LoginFulings=CHbcn
S_SHero_LoginSkyEquips=CHbco
S_SHero_LoginWingEquips=CHbcp
S_SHero_NewRole=CHbcq
S_SHero_PowerSelect=CHbcr
S_SHero_PropChange=CHbcs
S_SHero_SkillChange=CHbct
S_SHero_StudyBook=CHbcu
S_SHero_StudyFinalBook=CHbcv
S_SHero_Transition=CHbcw
S_SHero_UpdateFightFigureEquip=CHbcx
S_SHero_UpdateFuling=CHbcy
S_SHero_UpdateSuit=CHbcz
S_SHero_UpdateWingEquip=CHbcA
S_SHero_UpgradeToLegend=CHbcB
S_SHero_UpgradeToOrange=CHbcC
S_SHero_WingUseElixir=CHbcD
S_SHonor_Exchange=CHbcE
S_SHonor_FamilyRank=CHbcF
S_SHonor_PlayerRank=CHbcG
S_SInvestTurnTable_Draw=CHbcH
S_SInvestTurnTable_GetLogs=CHbcI
S_SInvestTurnTable_Update=CHbcJ
S_SInvite_getData=CHbcK
S_SInvite_getRmb=CHbcL
S_SInvite_getRmbSuccess=CHbcM
S_SInvite_takeReward=CHbcN
S_SKing_ChallengeEnd=CHbcO
S_SKing_MatchTargetSuc=CHbcP
S_SKing_OnOpen=CHbcQ
S_SKing_ReceiveRankBonus=CHbcR
S_SKing_StateChange=CHbcS
S_SLConnected=CHbcT
S_SLDisConnected=CHbcU
S_SLimitShopData=CHbcV
S_SLoginActivityData=CHbcW
S_SLogin_LoginResult=CHbcX
S_SLogin_Login_In_Other=CHbcY
S_SLotteryActivity_GetLogs=CHbcZ
S_SLotteryActivity_Suc=CHbc1
S_SLotteryConsume_RankInfo=CHbc2
S_SLotteryPlantTree_GetLogs=CHbc3
S_SLotteryPlantTree_Suc=CHbda
S_SLottery_GetLogs=CHbdb
S_SLottery_OneLog=CHbdc
S_SLottery_StorageChange=CHbdd
S_SLottery_Suc=CHbde
S_SLRegist=CHbdf
S_SLServerClosed=CHbdg
S_SLuckyTurnTable_OpenRet=CHbdh
S_SLuckyTurnTable_StartRet=CHbdi
S_SLuckyTurnTable_Update=CHbdj
S_SLunHui_AddExp=CHbdk
S_SLunHui_LunHui=CHbdl
S_SMagic_LevelupMagicKungfu=CHbdm
S_SMail_Delete=CHbdn
S_SMail_GetFj=CHbdo
S_SMail_GetFjs=CHbdp
S_SMail_getMails=CHbdq
S_SMail_newMail=CHbdr
S_SMail_readMail=CHbds
S_SMainboss_BonusShow=CHbdt
S_SMainCity_attmonster_rank=CHbdu
S_SMainCity_BATTLE_END=CHbdv
S_SMainCity_begin=CHbdw
S_SMainCity_BossEnd=CHbdx
S_SMainCity_changed=CHbdy
S_SMainCity_checkInCity=CHbdz
S_SMainCity_Enter=CHbdA
S_SMainCity_Exit=CHbdB
S_SMainCity_Family_Change=CHbdC
S_SMainCity_getEnvent=CHbdD
S_SMainCity_getPlayersInfo=CHbdE
S_SMainCity_getPlayerstate=CHbdF
S_SMainCity_HateAddbuff=CHbdG
S_SMainCity_HeroDecHp=CHbdH
S_SMainCity_HeroHPpush=CHbdI
S_SMainCity_HeroLoadEquip=CHbdJ
S_SMainCity_hurtInfo=CHbdK
S_SMainCity_MonsterInfo=CHbdL
S_SMainCity_Move=CHbdM
S_SMainCity_PlayerAttBoss=CHbdN
S_SMainCity_Reborn=CHbdO
S_SMainCity_Recover=CHbdP
S_SMainCity_selectEnvent=CHbdQ
S_SMaster_info=CHbdR
S_SMaster_out=CHbdS
S_SMaster_receiveMessage=CHbdT
S_SMazeBoxState=CHbdU
S_SMazeEnter=CHbdV
S_SMazeFirstInfo=CHbdW
S_SMazeItemNum=CHbdX
S_SMazeLeaveRoom=CHbdY
S_SMazePlayerMove=CHbdZ
S_SMazePlayerState=CHbd1
S_SMazeUseItem=CHbd2
S_SMeetUseBuffItemSuc=CHbd3
S_SMeet_GetRevenges=CHbea
S_SMeet_GetSelfMeetRank=CHbeb
S_SMeet_HasRevenge=CHbec
S_SMeet_ReportUp=CHbed
S_SMenpaiCross_battleStauts=CHbee
S_SMenpaiCross_BonfireStatus=CHbef
S_SMenpaiCross_DelItem=CHbeg
S_SMenpaiCross_FightEnd=CHbeh
S_SMenpaiCross_GetItem=CHbei
S_SMenpaiCross_Items=CHbej
S_SMenpaiCross_login=CHbek
S_SMenpaiCross_loginout=CHbel
S_SMenpaiCross_Move=CHbem
S_SMenpaiCross_otherEnter=CHben
S_SMenpaiCross_PlayerInfo=CHbeo
S_SMenpaiCross_Revival=CHbep
S_SMenpaiCross_sendgif=CHbeq
S_SMenpaiCross_setting=CHber
S_SMenpaiCross_TransmitReward=CHbes
S_SMenpaiCross_TransmitStatus=CHbet
S_SMenpaiCross_TransmitTip=CHbeu
S_SMenpai_info=CHbev
S_SMenpai_login=CHbew
S_SMergerActivityGetBonusSuc=CHbex
S_SMergerActivityUpdate=CHbey
S_SMergerFight_addTimes=CHbez
S_SMergerFight_DailyBonus=CHbeA
S_SMergerFight_Single_ChallengeSelectView=CHbeB
S_SMergerFight_Single_End=CHbeC
S_SMergerFight_Single_MatchTarget=CHbeD
S_SMergerFight_Single_WeekRankView=CHbeE
S_SMergerFight_StageBonus=CHbeF
S_SMiji_ReplacementSuc=CHbeG
S_SModuleClose=CHbeH
S_SModule_GetBonus=CHbeI
S_SMoneyTree_Change=CHbeJ
S_SMonster_Hp_Change=CHbeK
S_SMonthCard_Change=CHbeL
S_SMultiAttack=CHbeM
S_SMultiBlood=CHbeN
S_SMultiField_CollectFinish=CHbeO
S_SMultiField_CollectItem=CHbeP
S_SMultiField_CollectStatus=CHbeQ
S_SMultiField_DefenceStart=CHbeR
S_SMultiField_DelItem=CHbeS
S_SMultiField_Die=CHbeT
S_SMultiField_DieShow=CHbeU
S_SMultiField_Enter=CHbeV
S_SMultiField_Equips=CHbeW
S_SMultiField_GetItem=CHbeX
S_SMultiField_Items=CHbeY
S_SMultiField_Leave=CHbeZ
S_SMultiField_OtherEnter=CHbe1
S_SMultiField_OtherLeave=CHbe2
S_SMultiField_PlayerInfo=CHbe3
S_SMultiField_Revival=CHbfa
S_SMultiField_UpOwner=CHbfb
S_SMultiHeroDecHp=CHbfc
S_SMultiMonsterDecHp=CHbfd
S_SMultiOtherAttack=CHbfe
S_SMultiOtherMove=CHbff
S_SNightBiQi_AllRank=CHbfg
S_SNightBiQi_BuffAddition=CHbfh
S_SNightBiQi_BuffInfo=CHbfi
S_SNightBiQi_Death=CHbfj
S_SNightBiQi_End=CHbfk
S_SNightBiQi_Enter=CHbfl
S_SNightBiQi_Entry=CHbfm
S_SNightBiQi_KillInfo=CHbfn
S_SNightBiQi_Leave=CHbfo
S_SNightBiQi_Move=CHbfp
S_SNightBiQi_OtherEnter=CHbfq
S_SNightBiQi_PlayerInfo=CHbfr
S_SNightBiQi_Point_Change=CHbfs
S_SNightBiQi_RankInTime=CHbft
S_SNightBiQi_ReturnBorn=CHbfu
S_SNightBiQi_Score=CHbfv
S_SNightBiQi_ScoreReward=CHbfw
S_SNightBiQi_Turn=CHbfx
S_SNight_Phase_Change=CHbfy
S_SPlayerAllInfo=CHbfz
S_SPlayerFabaoInfo=CHbfA
S_SPlayerGetAchievementRewardInfo=CHbfB
S_SPlayerModuleShow=CHbfC
S_SPlayerOtherModeInfo=CHbfD
S_SPlayerPrivilegeCardInfo=CHbfE
S_SPlayerUpdateHeroIndex=CHbfF
S_SPlayerUpdateHeroJobIndex=CHbfG
S_SPlayer_Levelup=CHbfH
S_SPlayer_LevelUpMedal=CHbfI
S_SPlayer_PlayerDataChange=CHbfJ
S_SPlayer_PowerChange=CHbfK
S_SPlayer_State_Change=CHbfL
S_SPreventAddictionInfo=CHbfM
S_SpringFestivalBoss_EndReward=CHbfN
S_SpringFestivalBoss_EndTime=CHbfO
S_SpringFestivalBoss_OpenMark=CHbfP
S_SpringFestivalBoss_ScoreReward=CHbfQ
S_SPromotioCrazyReCharge_Update=CHbfR
S_SPromotionChargeBuy_Update=CHbfS
S_SPromotionConfig_Json=CHbfT
S_SPromotionConsumeRank_Info=CHbfU
S_SPromotionConsumeRebate_Info=CHbfV
S_SPromotionConsumeRebate_Update=CHbfW
S_SPromotionContentChange=CHbfX
S_SPromotionContinueCharge_Update=CHbfY
S_SPromotionDaily_Update=CHbfZ
S_SPromotionInfo=CHbf1
S_SPromotionLuckyTurn_Draw=CHbf2
S_SPromotionLuckyTurn_GetLogs=CHbf3
S_SPromotionLuckyTurn_Update=CHbga
S_SPromotionPromotionLuckyFish_Info=CHbgb
S_SPromotionRewardTurn_NeedUpdate=CHbgc
S_SPromotionRewardTurn_Update=CHbgd
S_SPromotionSpecialDaily_Update=CHbge
S_SPromotionTask_Update=CHbgf
S_SPromotioSingleRed_Charge_Draw=CHbgg
S_SPromotioSingleRed_Charge_Info=CHbgh
S_SPromotioSingleRed_Record=CHbgi
S_SPromotioSingleRed_SimpleInfo=CHbgj
S_SPromotioSingleRed_SimpleSend=CHbgk
S_SPromotioSingleRed_Take=CHbgl
S_SPromotioSpecial_Info=CHbgm
S_SPromotioSystemRed_End=CHbgn
S_SPromotioSystemRed_Info=CHbgo
S_SPromotioSystemRed_Send=CHbgp
S_SPromotioSystemRed_Take=CHbgq
S_SProtect_Boss_Result=CHbgr
S_SProtect_Enter_Result=CHbgs
S_SProtect_FamilyHurt_Result=CHbgt
S_SProtect_FamilyRank_Result=CHbgu
S_SProtect_Phase_Change=CHbgv
S_SProtect_Rank_Result=CHbgw
S_SProtect_Reborn_Result=CHbgx
S_SProtect_Soilder_Reward=CHbgy
S_SRankInfo=CHbgz
S_SRankPlayerInfo=CHbgA
S_SRankWorship=CHbgB
S_SRankWorships=CHbgC
S_SRechargeSuc=CHbgD
S_SReport_Meet=CHbgE
S_SReturnPlayer=CHbgF
S_SSandyCity_BuffAddition=CHbgG
S_SSandyCity_DailyReward=CHbgH
S_SSandyCity_End=CHbgI
S_SSandyCity_Enter=CHbgJ
S_SSandyCity_Entry=CHbgK
S_SSandyCity_FamilyRank=CHbgL
S_SSandyCity_FamilyState=CHbgM
S_SSandyCity_KillInfo=CHbgN
S_SSandyCity_KingFamilyChange=CHbgO
S_SSandyCity_LastFamilyRank=CHbgP
S_SSandyCity_LastPlayerRank=CHbgQ
S_SSandyCity_Leave=CHbgR
S_SSandyCity_Move=CHbgS
S_SSandyCity_NextField=CHbgT
S_SSandyCity_OtherEnter=CHbgU
S_SSandyCity_PlayerInfo=CHbgV
S_SSandyCity_PlayerRank=CHbgW
S_SSandyCity_RankInTime=CHbgX
S_SSandyCity_Reborn=CHbgY
S_SSandyCity_Score=CHbgZ
S_SSandyCity_ScoreReward=CHbg1
S_SSandyCity_StatusDestroy=CHbg2
S_SSandyCity_StatusScore=CHbg3
S_SScene_ActivityTake=CHbha
S_SScene_AddEmeny=CHbhb
S_SScene_BattleResult=CHbhc
S_SScene_BuffOff=CHbhd
S_SScene_ChapterBonus=CHbhe
S_SScene_Dead=CHbhf
S_SScene_DefenceStart=CHbhg
S_SScene_DefenceUpdate=CHbhh
S_SScene_DeleteEmeny=CHbhi
S_SScene_DeleteMeet=CHbhj
S_SScene_EnterScene=CHbhk
S_SScene_FMRankInfo=CHbhl
S_SScene_GetCopyCountsInfo_Sucess=CHbhm
S_SScene_GetCopyCountsRewad_Sucess=CHbhn
S_SScene_GetCopyCountsReward=CHbho
S_SScene_HpChange=CHbhp
S_SScene_HurtRanking=CHbhq
S_SScene_Left=CHbhr
S_SScene_Lottery=CHbhs
S_SScene_LotteryEnd=CHbht
S_SScene_Meet=CHbhu
S_SScene_MeetEnd=CHbhv
S_SScene_MyHurt=CHbhw
S_SScene_OfflineBonus=CHbhx
S_SScene_OtherPlayerEnterScene=CHbhy
S_SScene_QaunMingAttackHold=CHbhz
S_SScene_QaunMingAttention=CHbhA
S_SScene_QaunMingHoldChange=CHbhB
S_SScene_QaunMingKillLog=CHbhC
S_SScene_QuanMingBuffChange=CHbhD
S_SScene_QuanMingDieRelive=CHbhE
S_SScene_QuanmingEnd=CHbhF
S_SScene_RevengeEnd=CHbhG
S_SScene_Revive=CHbhH
S_SScene_SkillAction=CHbhI
S_SScene_SkillOn=CHbhJ
S_SScene_SpringFestivalWillStart=CHbhK
S_SScene_SummonBossState=CHbhL
S_SScene_SummonBossStates=CHbhM
S_SScene_SummonBossSuc=CHbhN
S_SScene_WorldBoss=CHbhO
S_SScene_WorldbossStart=CHbhP
S_SScene_ZhuanshengBossEnd=CHbhQ
S_SScene_ZhuanshengBossStart=CHbhR
S_SScene_ZhuanshengBossTarget=CHbhS
S_SScene_ZhuanshengCD=CHbhT
S_SScene_ZSRankInfo=CHbhU
S_SSendIndex=CHbhV
S_SSendLuckyShop_Info=CHbhW
S_SSendRechargeInfo=CHbhX
S_SServerMergerTime=CHbhY
S_SServerStartTime=CHbhZ
S_SSExchange_Result=CHbh1
S_SShareActivityHappy_AddTime=CHbh2
S_SShareActivityHappy_Draw=CHbh3
S_SShareActivityHappy_Info=CHbia
S_SShareActivityHappy_NextRound=CHbib
S_SShareActivityHappy_Start=CHbic
S_SShareActivityJiZan_Info=CHbid
S_SShareActivity_ClickFriend=CHbie
S_SShareActivity_DefenderInfo=CHbif
S_SShareActivity_Logs=CHbig
S_SShareActivity_RandomReward=CHbih
S_SShareActivity_ServerRank=CHbii
S_SShareActivity_Update=CHbij
S_SShareActivity_UpdateInfo=CHbik
S_SShare_Data=CHbil
S_SShare_DoubleBonus=CHbim
S_SShare_LinkData=CHbin
S_SShare_TuYouData=CHbio
S_SShoppingMall_Buy_Suc=CHbip
S_SShop_MysteryItemChange=CHbiq
S_SShop_PermitShopItemChange=CHbir
S_SSoulEquip_Changes=CHbis
S_SSoulEquip_Info=CHbit
S_SSoulEquip_Move=CHbiu
S_SSoulEquip_OpenGrid=CHbiv
S_SSoulEquip_Recycling=CHbiw
S_SSoulEquip_Unload=CHbix
S_SSoulEquip_Wear=CHbiy
S_SSoulShop_AuctionBuy=CHbiz
S_SSoulShop_AuctionDetail=CHbiA
S_SSoulShop_AuctionInfo=CHbiB
S_SSoulShop_DirectBuy=CHbiC
S_SSoulShop_EssenceBuy=CHbiD
S_SSoulShop_EssenceInfo=CHbiE
S_SSoulShop_HistoryPrice=CHbiF
S_SSoulShop_Status=CHbiG
S_SSoulShop_UpdateAuctionInfo=CHbiH
S_SSoulTask_BuyReceive=CHbiI
S_SSoulTask_BuyReel=CHbiJ
S_SSoulTask_Info=CHbiK
S_SSoulTask_Operating=CHbiL
S_SSoulTask_Refresh=CHbiM
S_SSoulTask_Update=CHbiN
S_SSYaoTower_BossHpChange=CHbiO
S_SSYaoTower_CD=CHbiP
S_SSYaoTower_Challenge=CHbiQ
S_SSYaoTower_DataChange=CHbiR
S_SSYaoTower_Enter=CHbiS
S_SSYaoTower_getInfo=CHbiT
S_SSYaoTower_Sweep=CHbiU
S_SSystem_BonusShow=CHbiV
S_SSystem_Error=CHbiW
S_SSystem_ErrorString=CHbiX
S_SSystem_GetBonus=CHbiY
S_SSystem_GetVesion=CHbiZ
S_SSystem_HB=CHbi1
S_SSystem_Stop=CHbi2
S_STask_UpdateTask=CHbi3
S_SThunderEquip_Convert=CHbja
S_SThunderEquip_cuiquget=CHbjb
S_SThunderEquip_getBaginfo=CHbjc
S_SThunderEquip_getinfo=CHbjd
S_STIME_Start=CHbje
S_STitle_Change=CHbjf
S_STitle_FirstHave=CHbjg
S_STongtianBattlefieldBox_ChangeState=CHbjh
S_STongtianBattlefieldBox_Obtain=CHbji
S_STongtianBattlefieldBox_ReadyObtain=CHbjj
S_STongtianBattlefieldBox_Show=CHbjk
S_STongtianBattlefield_AllRank=CHbjl
S_STongtianBattlefield_BuyBuff=CHbjm
S_STongtianBattlefield_Death=CHbjn
S_STongtianBattlefield_End=CHbjo
S_STongtianBattlefield_Enter=CHbjp
S_STongtianBattlefield_KillInfo=CHbjq
S_STongtianBattlefield_LayerReward=CHbjr
S_STongtianBattlefield_Leave=CHbjs
S_STongtianBattlefield_Move=CHbjt
S_STongtianBattlefield_OtherEnter=CHbju
S_STongtianBattlefield_PlayerInfo=CHbjv
S_STongtianBattlefield_PlayerInfoChange=CHbjw
S_STongtianBattlefield_RankInTime=CHbjx
S_STongtianBattlefield_ReturnBorn=CHbjy
S_STongtianBattlefield_Score=CHbjz
S_STotalChargeActivityData=CHbjA
S_STurnTable_GetLogs=CHbjB
S_STurnTable_Open=CHbjC
S_STurnTable_ScoreUpdate=CHbjD
S_STurnTable_Suc=CHbjE
S_STuYou_SignStates=CHbjF
S_SUpdate_functionInfo=CHbjG
S_SUseBuffItemSuc=CHbjH
S_SValhallaInfo=CHbjI
S_SValhallaStateChange=CHbjJ
S_SValhallaSynthesisSuccess=CHbjK
S_SVipGiftActivityInfo=CHbjL
S_SVipGiftTake=CHbjM
S_SVipGiftYbPush=CHbjN
S_SVip_GetVipBonus=CHbjO
S_SVip_HideVip=CHbjP
S_SVip_OnVipChange=CHbjQ
S_SWatch_Info=CHbjR
S_SWingEquipUpSuc=CHbjS
S_SWingEquip_ChangePosSuc=CHbjT
S_SWingFashion_off=CHbjU
S_SXiuwei_rewardinfoget=CHbjV
S_SZhuanshengtask_infoget=CHbjW
S_SZhuansheng_AddExp=CHbjX
S_SZhuansheng_Zhuansheng=CHbjY
S_S_UpdateArtifacts=CHbjZ
CompressTextureProcessor=CHbj1
PackETC1KTXProcessor=CHbj2
GameLoading=CHbj3
LoadManager=CHbka
ActivityDailyBounsRender=CHbkb
ActivityDailyTreasure=CHbkc
BigDailyBounsVo=CHbkd
BRMMdu=CHbke
BRMMed=CHbkf
BRMCfg=CHbkg
BRMEvt=CHbkh
BRMMod=CHbki
BRMDhView=CHbkj
BRMGetView=CHbkk
BRMPnl=CHbkl
BRMRwdsView=CHbkm
BRMBoxVo=CHbkn
BigRichBoxRender=CHbko
BRMItemR=CHbkp
ComradeModel=CHbkq
ComradeRwdvo=CHbkr
ComradeHyvo=CHbks
ComradeModule=CHbkt
ComradeViewMediator=CHbku
ComradeListRender=CHbkv
ComradeRwdRender=CHbkw
ComradePnl=CHbkx
PltBridge=CHbky
RedChecker1=CHbkz
BigRichMoneyManager=CHbkA
ThemeAdapter=CHbkB
BinaryBuffer=CHbkC
CByteArray=CHbkD
RoseParticle=CHbkE
SnowParticle=CHbkF
SparkParticle=CHbkG
ParticleBase=CHbkH
ParticleEaseUtil=CHbkI
FestivalSpringPlaysetExt=CHbkJ
FstBetCfgSVo=CHbkK
FstBetCfgVo=CHbkL
ImageCache=CHbkM
subBaseModel=CHbkN
subEuiComponentBase=CHbkO
subModuleBase=CHbkP
subObserver=CHbkQ
subViewBase=CHbkR
CollectMdu=CHbkS
CollectMed=CHbkT
TyCollectEui=CHbkU
pcakModuleManager=CHbkV
tyPhoneBindMdu=CHbkW
tyPhoneBindMed=CHbkX
tyPhoneBindEui=CHbkY
tyPhoneGuideEui=CHbkZ
PubAddressMdu=CHbk1
PubAddressMed=CHbk2
PubTipAlert=CHbk3
SuperKefuMed=CHbla
PubAdressEui=CHblb
PubTipAlertEui=CHblc
VipKeFuEui=CHbld
shareEvtType=CHble
ShareGameMod=CHblf
ShareModel=CHblg
ShareGameMed=CHblh
ShareModule=CHbli
ShareViewMediator=CHblj
HyPkResult=CHblk
ShareEatLogRnd=CHbll
ShareEatPalyerRnd=CHblm
ShareEatPlayerAniman=CHbln
ShareEatRnkRnd=CHblo
ShareEatRwdLogRnd=CHblp
ShareEatRwdRnd=CHblq
ShareCaitem=CHblr
ShareCardEui=CHbls
ShareCReward=CHblt
ShareDisJilu=CHblu
ShareEatPlayerEui=CHblv
ShareEatPnlEui=CHblw
ShareEatRankEui=CHblx
ShareEatResultEui=CHbly
ShareEatRwdEui=CHblz
ShareHyDiscEui=CHblA
ShareHyPkEui=CHblB
SharehyPkRener=CHblC
ShareJiluRender=CHblD
ShareJiZanEui=CHblE
ShareJizanRender=CHblF
ShareLinkEui=CHblG
ShareLinkitm=CHblH
SharelinkUseitemEui=CHblI
SharePanel=CHblJ
sharepkTxitem=CHblK
ShareTipsEui=CHblL
Shouquanpanl=CHblM
ActPlyerVo=CHblN
ShareJzPlayvo=CHblO
PhoneBindMdu=CHblP
PhoneBindMed=CHblQ
PhoneBindEui=CHblR
PhoneGuideEui=CHblS
BdSDKManager=CHblT
meizuplatform=CHblU
oppoplatform=CHblV
QQSDKManager=CHblW
TTSDKManager=CHblX
tyWxplatform=CHblY
vivoplatform=CHblZ
WxSDKManager=CHbl1
xiaomiplatform=CHbl2
DateU=CHa
TyAdClickStaType=CHb
ConstSharePoint=CHc
ConstBilog=CHd
GameSendLogUtil=CHe
QQGameLogStep=CHf
pub_AppCifng=CHh
SdkEvent=CHi
ConstPlt=CHj
SubPlt=CHk
SdkManager=CHl
Platform=CHm
DebugPlatform=CHo
QufuAlertPanelView=CHp
RestartAlertView=CHq
QufuLoading=CHr
QufuProxy=CHs
QufuServeVo=CHt
ButtonQuFuview=CHu
NoticeView=CHv
QufuAlertView=CHw
QuFuInterRenderView=CHx
QuFuSelectRenderView=CHy
QufuSelectView=CHz
QufuManager=CHA
PubDate=CHB
